border_size=1
usage=map

Aa          , Aa          , Aa          , Aa          , Aa          , Aa          , Aa          , Aa          , Aa          , Aa          , Aa          , Aa          , Aa          , Aa          , Aa          , Aa          , Aa          , Aa          , Ai          , Ai          , Ai          , Ai          , Ai          , Ai          , Ai          , Ai          , Aa          , Aa          , Aa          , Aa          , Aa          , Aa          , Ha          , Mm          , Ha          , Ha          , Aa          , Rd          , Aa          , Aa          , Aa          , Aa          
Aa          , Aa          , Aa          , Aa          , Aa^Voa      , Aa          , Aa          , Aa          , Aa          , Aa          , Aa          , Aa          , Gs          , Gs          , Gs          , Aa          , Aa          , Aa          , Ai          , Ai          , Ai          , Ai          , Ai          , Ai          , Ai          , Ai          , Aa          , Aa          , Gs          , Aa          , Aa          , Aa          , Ha          , Mm          , Ha          , Ha          , Aa          , Rd          , Aa^Voa      , Aa          , Aa          , Aa          
Aa          , Aa          , Aa          , Aa          , Aa          , Aa          , Aa          , Aa          , Aa          , Aa          , Aa          , Aa          , Gs          , Gs          , Gs          , Aa          , Aa          , Aa          , Aa          , Ai          , Ai          , Ai          , Ai          , Ai          , Ai          , Ai          , Aa          , Gs          , Gs          , Gs          , Aa          , Aa          , Aa          , Ha^Fpa      , Aa^Fpa      , Aa^Fpa      , Ha^Fpa      , Aa          , Ha          , Ha          , Ha          , Ha          
Aa          , Aa          , Gs          , Aa          , Aa          , Aa          , Aa          , Aa          , Aa          , Aa          , Aa          , Aa          , Aa          , Gs          , Aa          , Aa          , Aa          , Aa          , Aa          , Ha          , Hh          , Ai          , Ai          , Ai          , Ai          , Ai          , Aa          , Gs          , Aa          , Gs          , Aa          , Aa          , Aa          , Aa^Fpa      , Aa^Fpa      , Ha          , Ha          , Ha          , Mm          , Mm          , Mm          , Mm          
Aa          , Gs          , Gs          , Gs          , Aa          , Aa          , Co          , Co          , Co          , Aa          , Aa          , Aa^Voa      , Aa          , Aa          , Aa          , Aa          , Aa          , Aa          , Ha          , Hh          , Hh          , Ha          , Aa^Voa      , Ai          , Ai          , Ai          , Ai          , Aa          , Gs^Fp       , Aa          , Aa          , Aa          , Aa^Fpa      , Aa^Fpa      , Co          , Co          , Co          , Ha          , Ha          , Mm          , Mm          , Mm          
Aa          , Gs          , Gs          , Gs          , Aa          , Aa          , Co          , 2 Ko        , Co          , Aa          , Aa          , Aa          , Gs^Fp       , Aa^Fpa      , Aa^Voa      , Aa^Fpa      , Aa          , Aa          , Ha          , Hh          , Hh          , Ha          , Ai          , Aa^Fpa      , Ai          , Ai          , Aa^Voa      , Gs^Fp       , Rd          , Aa^Fpa      , Aa          , Aa          , Aa^Fpa      , Aa^Fpa      , Co          , 3 Ko        , Co          , Ha          , Mm          , Mm          , Mm          , Mm          
Aa          , Aa          , Aa          , Aa          , Aa          , Aa          , Co          , Co          , Co          , Aa          , Aa          , Gs^Fp       , Gs^Fp       , Aa^Fpa      , Aa^Fpa      , Aa^Fpa      , Ha^Fpa      , Aa          , Ha          , Ha          , Ha          , Ai          , Aa^Fpa      , Ai          , Aa^Fpa      , Ai          , Aa^Fpa      , Aa^Fpa      , Aa^Fpa      , Aa^Fpa      , Aa^Fpa      , Aa^Fpa      , Aa^Fpa      , Aa^Fpa      , Co          , Co          , Co          , Ha          , Mm          , Hh          , Mm          , Mm          
Aa          , Aa          , Aa          , Aa          , Aa^Voa      , Aa          , Gs^Fp       , Gs^Fp       , Gs^Fp       , Aa          , Aa          , Gs^Fp       , Aa^Fpa      , Aa^Fpa      , Ha^Fpa      , Ha^Fpa      , Ha          , Ha          , Hh          , Hh          , Ha          , Ai          , Ai          , Aa^Fpa      , Gs^Fp       , Gs^Fp       , Gs^Fp       , Gs^Fp       , Aa^Fpa      , Gs^Fp       , Ai          , Aa^Fpa      , Aa^Fpa      , Aa^Fpa      , Aa^Fpa      , Ha          , Ha          , Hh          , Mm          , Mm          , Mm          , Mm          
Aa          , Aa          , Gs^Fp       , Aa^Fpa      , Aa          , Aa          , Rd          , Rd          , Aa^Fpa      , Aa^Fpa      , Aa^Fpa      , Ai          , Aa^Fpa      , Aa^Fpa      , Ha          , Ha          , Ha          , Hh          , Hh          , Hh          , Hh          , Ai          , Ai          , Aa^Fpa      , Aa^Fpa      , Aa^Fpa      , Gs^Fp       , Gs^Fp       , Gs^Fp       , Gs^Fp       , Gs^Fp       , Aa^Fpa      , Aa^Fpa      , Aa^Fpa      , Aa^Fpa      , Aa          , Aa          , Hh          , Ha          , Hh          , Hh          , Hh          
Aa          , Aa          , Aa          , Gs^Fp       , Aa^Fpa      , Rd          , Rd          , Aa^Voa      , Rd          , Aa^Fpa      , Aa          , Aa^Fpa      , Aa^Fpa      , Aa^Fpa      , Aa^Fpa      , Ha^Fpa      , Ha          , Hh          , Hh          , Hh          , Aa          , Ai          , Aa^Voa      , Aa^Fpa      , Aa          , Aa          , Gs^Fp       , Gs^Fp       , Gs^Fp       , Gs^Fp       , Aa^Fpa      , Gs^Fp       , Aa^Fpa      , Aa^Fpa      , Aa^Fpa      , Aa^Fpa      , Aa          , Ha          , Aa          , Aa          , Hh          , Hh          
Aa          , Aa          , Gs^Fp       , Gs^Fp       , Aa^Fpa      , Aa^Fpa      , Aa^Fpa      , Aa^Fpa      , Aa^Fpa      , Aa          , Aa^Fpa      , Aa^Fpa      , Aa^Fpa      , Aa^Fpa      , Ha          , Ha          , Aa          , Aa          , Aa          , Aa          , Aa          , Aa          , Aa          , Aa          , Aa          , Aa          , Aa          , Gs^Fp       , Gs^Fp       , Gs^Fp       , Aa          , Gs^Fp       , Aa          , Aa          , Aa          , Aa          , Aa          , Aa          , Aa          , Aa          , Aa          , Aa          
Gs^Fp       , Gs^Fp       , Gs^Fp       , Gs^Fp       , Ha^Fpa      , Ha^Fpa      , Aa^Fpa      , Aa^Fpa      , Aa^Fpa      , Aa^Fpa      , Aa^Fpa      , Aa^Fpa      , Aa^Voa      , Aa^Fpa      , Re          , Re          , Re          , Aa          , Re          , Aa          , Aa          , Aa          , Aa          , Aa          , Aa          , Aa          , Aa          , Aa          , Aa          , Aa          , Aa          , Aa          , Aa          , Aa          , Aa          , Aa          , Aa^Voa      , Aa          , Aa          , Aa          , Aa          , Aa          
Aa^Fpa      , Gs^Fp       , Aa^Fpa      , Gs^Fp       , Aa^Fpa      , Ha          , Aa^Fpa      , Aa^Fpa      , Gs^Fp       , Aa^Fpa      , Ha^Fpa      , Ha          , Ha          , Re          , Rd          , Hh          , Hh^Vo       , Re          , Gs          , Re          , Re          , Re          , Aa          , Aa          , Aa          , Aa          , Aa          , Aa          , Aa          , Aa          , Aa          , Aa          , Aa          , Aa^Voa      , Aa          , Aa          , Aa          , Aa          , Aa          , Aa          , Aa          , Aa          
Aa^Fpa      , Aa^Fpa      , Aa^Voa      , Aa^Fpa      , Ha          , Ha          , Aa^Fpa      , Gs^Fp       , Gs^Fp       , Aa^Fpa      , Aa          , Ha          , Ha          , Rd          , Hh          , Hh          , Aa          , Gs          , Gs          , Gs          , Aa          , Aa          , Aa          , Aa          , Gg^Vo       , Aa          , Aa          , Mm          , Aa          , Aa^Voa      , Aa          , Aa          , Aa          , Aa          , Aa          , Aa          , Aa          , Aa          , Aa          , Aa          , Ha          , Ha          
Ha          , Ha          , Aa^Fpa      , Aa^Fpa      , Aa^Fpa      , Aa^Fpa      , Gs^Fp       , Gs^Fp       , Gs^Fp       , Gs^Fp       , Re          , Aa          , Aa          , Ha          , Ha          , Ha          , Aa          , Gs          , Gs          , Gs          , Aa          , Hh          , Hh          , Aa          , Aa          , Aa          , Aa          , Mm          , Mm          , Aa          , Aa          , Aa          , Gs          , Gs          , Gs          , Aa          , Aa          , Aa          , Aa          , Ha          , Mm          , Mm          
Ha          , Ha          , Ha          , Ha^Fpa      , Ha^Fpa      , Aa^Fpa      , Aa^Fpa      , Gs^Fp       , Aa          , Aa          , Aa          , Aa          , Ha          , Ha^Fpa      , Ha^Fpa      , Ha          , Ha          , Aa          , Aa          , Aa          , Ha          , Hh          , Hh          , Hh          , Aa          , Aa          , Aa          , Mm          , Mm          , Aa          , Aa          , Aa          , Gs          , Gs          , Gs          , Aa          , Aa          , Hh          , Hh          , Ha          , Mm          , Mm          
Aa          , Aa          , Ha          , Ha^Fpa      , Ha          , Aa^Fpa      , Ha^Voa      , Aa^Fpa      , Re          , Re          , Hh          , Ha          , Ha          , Ha^Fpa      , Ha          , Ha          , Ha          , Aa          , Ha          , Ha          , Ha          , Hh          , Hh          , Hh          , Aa^Voa      , Aa          , Aa          , Aa          , Mm          , Aa          , Aa          , Aa          , Aa          , Gs          , Aa          , Aa          , Hh          , Hh          , Hh          , Mm          , Mm          , Mm          
Aa          , Aa          , Aa          , Ha          , Ha          , Ha          , Aa          , Aa          , Aa          , Hh          , Hh          , Ha          , Ha          , Ha          , Mm          , Aa          , Aa          , Ha          , Ha          , Mm          , Mm          , Mm          , Hh          , Mm          , Aa          , Aa          , Aa          , Aa          , Mm          , Mm          , Aa          , Aa          , Aa          , Aa          , Aa          , Aa          , Hh          , Hh          , Hh          , Mm          , Mm          , Mm          
Aa          , Aa          , Ha          , Ha          , Ha          , Aa          , Hh          , Re          , Aa          , Ha          , Aa          , Aa          , Aa          , Mm          , Mm          , Mm          , Aa          , Ha          , Hh          , Mm          , Mm          , Mm          , Mm          , Mm          , Aa          , Aa          , Aa          , Aa          , Mm          , Aa          , Aa          , Aa          , Aa          , Aa^Voa      , Aa          , Hh          , Mm          , Mm          , Mm          , Mm          , Aa^Voa      , Aa          
Aa          , Aa          , Aa          , Aa          , Ha          , Ha          , Aa          , Re          , Re          , Ha          , Aa^Voa      , Aa          , Aa          , Aa          , Aa          , Mm          , Ha          , Hh          , Hh          , Mm          , Mm          , Mm          , Aa          , Aa          , Gs^Fp       , Aa          , Aa          , Aa          , Aa          , Mm          , Aa          , Aa          , Aa          , Aa          , Aa          , Hh          , Ha          , Ha          , Mm          , Mm          , Aa          , Aa          
Aa          , Aa          , Aa          , Aa          , Hh          , Hh          , Aa          , Aa          , Hh          , Re          , Re          , Aa          , Aa          , Aa          , Aa          , Ha          , Ha^Vca      , Hh          , Mm          , Mm          , Mm          , Gs^Fp       , Aa          , Aa^Fpa      , Gs^Fp       , Aa^Fpa      , Aa^Voa      , Aa          , Aa          , Mm          , Mm          , Aa          , Aa          , Aa          , Aa          , Aa          , Ha          , Mm          , Mm          , Mm          , Mm          , Mm          
Aa          , Gs          , Gs          , Aa          , Hh          , Aa          , Aa          , Aa^Voa      , Aa          , Hh          , Hh          , Re          , Aa          , Aa          , Aa          , Aa          , Ha          , Aa^Fpa      , Gs^Fp       , Gs^Fp       , Gs^Fp       , Gs^Fp       , Aa^Fpa      , Aa          , Gs^Fp       , Gs^Fp       , Gs^Fp       , Mm          , Aa          , Mm          , Aa          , Aa          , Aa          , Aa          , Aa          , Aa          , Mm          , Mm          , Mm          , Mm          , Mm          , Mm          
Aa          , Gs          , Gs          , Aa          , Aa          , Aa          , Aa          , Aa          , Hh          , Hh          , Hh          , Hh^Vo       , Aa          , Aa          , Aa          , Aa          , Aa^Fpa      , Aa^Fpa      , Aa^Fpa      , Aa^Fpa      , Aa          , Aa^Fpa      , Aa^Voa      , Aa          , Gs^Fp       , Gs^Fp       , Aa^Fpa      , Mm          , Mm          , Mm          , Mm          , Aa          , Aa          , Aa          , Aa          , Aa          , Aa          , Ai          , Aa^Voa      , Mm          , Mm          , Mm          
Aa          , Gs          , Aa          , Aa          , Aa          , Aa          , Ha          , Ha          , Hh          , Hh          , Hh          , Hh          , Aa          , Aa          , Aa          , Aa^Fpa      , Aa          , Aa^Fpa      , Aa^Fpa      , Aa          , Aa          , Aa^Fpa      , Aa^Fpa      , Gs^Fp       , Aa^Fpa      , Gs^Fp       , Aa^Fpa      , Mm          , Mm          , Mm          , Mm          , Aa^Voa      , Aa          , Aa          , Aa          , Aa          , Ai          , Ai          , Ai          , Mm          , Mm          , Mm          
Aa          , Aa          , Aa          , Aa          , Aa          , Aa          , Hh          , Ha          , Aa          , Aa          , Aa          , Aa          , Aa          , Aa          , Gs^Fp       , Aa^Fpa      , Aa^Fpa      , Aa          , Aa^Fpa      , Ha^Fpa      , Ha          , Aa^Fpa      , Aa^Fpa      , Ha^Fpa      , Rd          , Rd          , Rd          , Aa^Voa      , Mm          , Mm          , Mm          , Aa          , Aa          , Aa          , Aa          , Aa          , Aa          , Ai          , Ai          , Mm          , Mm          , Mm          
Aa          , Aa          , Aa          , Aa          , Aa          , Hh          , Hh          , Ha          , Aa          , Aa          , Aa          , Aa^Voa      , Re          , Gs^Fp       , Gs^Fp       , Aa^Fpa      , Gs^Fp       , Aa^Fpa      , Ha^Fpa      , Ha          , Ha          , Ha          , Ha^Fpa      , Ha          , Rd          , Rd          , Aa          , Aa          , Mm          , Mm          , Mm          , Mm          , Aa          , Aa          , Aa          , Aa          , Ai          , Ai          , Ai          , Ai          , Mm          , Mm          
Aa          , Aa          , Aa          , Aa          , Aa          , Aa^Voa      , Aa          , Aa          , Gs          , Aa          , Aa          , Aa          , Re          , Aa          , Gs^Fp       , Gs^Fp       , Aa          , Gs^Fp       , Hh          , Ha          , Ha          , Ha^Fpa      , Ha^Fpa      , Ha          , Ha          , Ha          , Aa          , Mm          , Mm          , Mm          , Mm          , Mm          , Aa          , Aa          , Aa          , Mm          , Mm          , Ai          , Ai          , Ai          , Mm          , Mm          
Aa          , Aa          , Aa^Voa      , Aa          , Aa          , Aa          , Aa          , Gs          , Gs          , Gs          , Aa          , Aa          , Re          , Aa          , Aa          , Aa          , Aa          , Hh          , Ha          , Ha^Vca      , Ha          , Ha          , Hh          , Hh          , Hh          , Hh          , Hh          , Mm          , Mm          , Mm          , Mm          , Aa          , Aa          , Mm          , Aa          , Mm          , Mm          , Mm          , Ai          , Mm          , Mm          , Mm          
Aa          , Aa          , Aa          , Aa^Fpa      , Aa          , Aa          , Aa          , Gs          , Gs          , Gs          , Aa          , Aa          , Aa          , Re          , Aa          , Aa          , Aa          , Aa          , Aa          , Hh          , Hh          , Hh          , Hh          , Mm          , Mm          , Mm          , Mm          , Mm          , Mm          , Mm          , Mm          , Aa^Voa      , Mm          , Mm          , Mm          , Mm          , Mm          , Mm          , Ai          , Mm          , Mm          , Mm          
Aa          , Aa          , Aa          , Aa^Fpa      , Aa^Fpa      , Aa          , Aa          , Aa          , Aa          , Aa          , Aa          , Aa          , Aa          , Re          , Aa          , Aa          , Aa          , Aa          , Aa          , Hh          , Mm          , Mm          , Mm          , Mm          , Mm          , Mm          , Mm          , Mm          , Hh          , Mm          , Mm          , Mm          , Ha          , Mm          , Ai          , Ai          , Ai          , Mm          , Mm          , Ai          , Ai          , Ai          
Aa^Fpa      , Aa^Fpa      , Aa^Fpa      , Aa^Fpa      , Aa          , Aa          , Aa          , Aa          , Aa          , Aa          , Aa          , Aa^Fpa      , Aa          , Aa          , Aa          , Aa          , Aa          , Aa          , Aa          , Aa          , Aa^Voa      , Mm          , Mm          , Mm          , Mm          , Mm          , Mm          , Mm          , Hh          , Hh          , Hh          , Ha          , Aa          , Mm          , Mm          , Ai          , Mm          , Mm          , Mm          , Aa^Voa      , Aa          , Aa          
Aa^Fpa      , Aa^Fpa      , Aa          , Aa          , Aa^Fpa      , Aa^Fpa      , Aa          , Aa          , Aa          , Aa          , Aa          , Aa^Fpa      , Aa^Fpa      , Aa^Voa      , Aa          , Aa          , Aa          , Aa          , Aa          , Ai          , Ai          , Mm          , Mm          , Mm          , Aa          , Mm          , Mm          , Mm          , Mm          , Hh          , Mm          , Mm          , Aa          , Mm          , Mm          , Mm          , Mm          , Mm          , Mm          , Aa          , Aa          , Aa          
Aa^Fpa      , Aa^Fpa      , Aa          , Aa          , Aa          , Aa^Fpa      , Aa^Fpa      , Aa          , Aa          , Aa          , Rd          , Gs^Fp       , Aa^Fpa      , Gs^Fp       , Aa          , Aa          , Aa          , Aa          , Ai          , Ai          , Ai          , Ai          , Mm          , Mm          , Mm          , Mm          , Mm          , Mm          , Mm          , Mm          , Mm          , Aa          , Aa          , Mm          , Mm          , Mm          , Mm          , Mm          , Mm          , Aa          , Aa          , Aa          
Aa^Fpa      , Aa^Fpa      , Aa          , Aa^Fpa      , Aa^Fpa      , Aa^Fpa      , Aa^Fpa      , Aa^Fpa      , Aa^Fpa      , Aa          , Gs^Fp       , Gs^Fp       , Gs^Fp       , Aa^Fpa      , Gs^Fp       , Aa^Fpa      , Aa          , Ai          , Ai          , Ai          , Aa          , Aa          , Mm          , Mm          , Ha          , Mm          , Mm          , Mm          , Mm          , Mm          , Mm          , Aa          , Aa          , Aa          , Mm          , Mm          , Aa          , Mm          , Aa          , Aa          , Aa          , Aa          
Aa^Fpa      , Gs^Fp       , Aa^Fpa      , Gs^Fp       , Gs^Fp       , Aa^Vca      , Gs^Fp       , Gs^Fp       , Gs^Fp       , Gs^Fp       , Gs^Fp       , Ce          , Ce          , Ce          , Gs^Fp       , Aa^Fpa      , Gs^Fp       , Ai          , Ai          , Ai          , Aa          , Aa          , Aa          , Ha          , Aa          , Hh          , Hh          , Mm          , Mm          , Aa          , Aa          , Aa          , Aa          , Aa          , Aa          , Aa          , Mm          , Aa          , Aa          , Aa          , Aa          , Aa          
Aa^Fpa      , Aa^Fpa      , Gs^Fp       , Gs^Fp       , Gs^Fp       , Aa^Fpa      , Gs^Fp       , Rd          , Rd          , Rd          , Aa^Fpa      , Ce          , 1 Ke        , Ce          , Aa^Fpa      , Gs^Fp       , Ai          , Ai          , Ai          , Aa          , Aa          , Aa^Voa      , Aa          , Aa          , Aa^Vca      , Ha          , Mm          , Mm          , Mm          , Mm          , Aa          , Aa          , Aa          , Aa          , Aa          , Mm          , Aa          , Aa          , Aa^Voa      , Aa          , Aa          , Aa          
Aa          , Aa          , Aa^Fpa      , Aa^Fpa      , Aa^Fpa      , Rd          , Aa^Fpa      , Rd          , Rd          , Aa          , Rd          , Ce          , Ce          , Ce          , Aa          , Aa^Vca      , Gs          , Gs          , Gs          , Aa          , Aa          , Aa          , Aa          , Aa          , Aa          , Ha          , Mm          , Mm          , Mm          , Mm          , Mm          , Aa          , Aa          , Aa          , Aa          , Mm          , Mm          , Mm          , Aa          , Aa          , Aa          , Aa          
Aa          , Aa          , Aa          , Aa^Vca      , Aa^Fpa      , Rd          , Aa          , Rd          , Rd          , Rd          , Rd          , Aa          , Rd          , Aa          , Aa          , Aa          , Gs          , Gs          , Gs          , Aa          , Aa          , Aa          , Aa          , Aa          , Aa          , Aa          , Hh          , Hh          , Mm          , Mm          , Aa          , Aa          , Aa          , Aa          , Aa^Voa      , Aa          , Aa          , Mm          , Aa          , Aa          , Aa          , Aa          
Aa          , Aa          , Aa          , Aa          , Aa^Fpa      , Aa^Fpa      , Aa          , Aa          , Aa          , Aa          , Rd          , Rd          , Rd          , Aa          , Aa          , Aa          , Aa          , Gs          , Aa          , Aa          , Aa          , Aa          , Ha          , Ha          , Ha          , Aa          , Hh          , Hh          , Mm          , Mm          , Aa          , Aa          , Aa          , Aa          , Aa          , Aa          , Aa          , Aa^Voa      , Aa          , Aa          , Aa          , Aa          
Rd          , Aa          , Aa          , Aa          , Aa^Fpa      , Aa^Fpa      , Aa          , Aa          , Aa          , Rd          , Rd          , Rd          , Rd          , Rd          , Aa          , Aa          , Aa          , Aa          , Aa          , Aa          , Hh          , Aa          , Hh          , Aa          , Rd          , Ha          , Hh          , Hh          , Hh          , Aa          , Aa          , Aa          , Aa          , Aa          , Aa          , Gs          , Gs          , Aa          , Ha          , Aa          , Ha          , Ha          
Aa          , Rd          , Aa          , Aa          , Aa          , Aa          , Aa          , Aa          , Aa          , Rd          , Aa          , Aa          , Aa          , Aa          , Aa          , Aa          , Rd          , Aa          , Rd          , Ha          , Ha          , Hh          , Aa          , Aa          , Rd          , Rd          , Ha          , Ha          , Aa          , Aa          , Aa          , Aa          , Aa          , Aa          , Aa          , Gs          , Gs          , Aa          , Ha          , Ha          , Ha          , Ha          
Rd          , Rd          , Rd          , Aa          , Aa          , Aa          , Aa          , Aa          , Aa          , Aa          , Aa          , Aa          , Aa          , Aa          , Aa          , Aa          , Aa          , Aa          , Rd          , Ha          , Ha          , Ha          , Aa          , Aa          , Aa          , Aa          , Ha          , Hh          , Aa          , Aa          , Aa          , Aa          , Aa          , Aa          , Aa          , Aa          , Aa          , Aa          , Ha          , Ha          , Ha          , Ha          
