border_size=1
usage=map

Ha          , Ha          , Ha          , Ha          , Ha          , Ha          , Ha          , Ha          , Ha          , Ha          , Ha          , Ha          , Ha          , Ha          , Ha          , Ha          , Ha          , Ha          , Ha          , Ha          , Ha          , Ha          , Ha          , Ha          , Ha          , Ha          , Ha          , Ha          , Ms          , Ha          , Ha          , Ha          , Ha          , Ha          , Ha          , Aa          
Ha          , Ha          , Ce          , Ce          , Ce          , Ha          , Ha          , Ha          , Aa^Fma      , Aa^Fma      , Aa^Fma      , Ha          , Ha          , Aa^Fda      , Aa^Fda      , Aa^Fda      , Ha          , Ha          , Ms^Xo       , Ms^Xo       , Ms^Xo       , Ha^Vhha     , Aa^Fda      , Ha          , Ms          , Ha          , Ha          , Ha          , Ha          , Ha          , Ha          , Ha^Vhha     , Ha          , Ha          , Ha          , Ha          
Ha          , Ha          , Ce          , 1 Ke        , Ce          , Ha          , Ha          , Ha          , Ha          , Aa^Fma      , Ha          , Ha          , Ha          , Ha          , Ms^Xo       , Ms^Xo       , Ms^Xo       , Ha          , Ms^Xo       , Ms^Xo       , Ms^Xo       , Aa^Fda      , Aa^Fda      , Ms          , Ha^Fpa      , Ms          , Ha          , Ha          , Ms          , Ha          , Ha          , Ha          , Ha          , Aa          , Aa          , Aa          
Ha          , Ha          , Ha          , Ce          , Ha          , Ha          , Ha          , Ha          , Ha          , Ha          , Ha          , Ha          , Aa^Fma      , Ha          , Aa          , Ms^Xo       , Ha          , Ha          , Aa^Fda      , Ms^Xo       , Ha^Fpa      , Ha^Fpa      , Aa^Fda      , Ha^Fpa      , Ms          , Ha          , Ha          , Ms          , Ms          , Ha          , Ha          , Ha          , Aa          , Aa          , Aa          , Aa          
Ha          , Ha          , Ha          , Ha          , Ms          , Ha          , Ms          , Ms          , Ms^Xo       , Ms          , Aa^Fma      , Aa^Fma      , Ha          , Aa^Fma      , Ha          , Ha          , Ms^Xo       , Aa^Fda      , Ha          , Ha          , Ms          , Ha^Fpa      , Ms^Xo       , Ms^Xo       , Ms^Xo       , Ms          , Ha^Vhha     , Ha          , Ha          , Ha          , Ha          , Ha^Vhha     , Aa          , Aa          , Aa          , Aa          
Ha          , Ha          , Ms^Xo       , Ms^Xo       , Ms^Xo       , Ms          , Ms^Xo       , Ms^Xo       , Ha^Vhha     , Ms^Xo       , Ms^Xo       , Ha          , Ha          , Ha          , Ms          , Ms^Xo       , Ms^Xo       , Ms^Xo       , Ha          , Ms          , Ms          , Ms          , Ms          , Ms^Xo       , Ms          , Ha          , Ha          , Ha          , Ms^Xo       , Ms^Xo       , Ha          , Aa          , Ha^Fpa      , Ha^Fpa      , Aa          , Aa          
Ms^Xo       , Ms          , Ms^Xo       , Ms^Xo       , Aa          , Ms^Xo       , Aa          , Aa          , Aa          , Aa          , Ha^Fpa      , Ha^Xo       , Ms^Xo       , Ms          , Ms^Xo       , Ms^Xo       , Ha^Fpa      , Ha^Fpa      , Ha^Fpa      , Ha^Fpa      , Ha          , Ms          , Ms^Xo       , Ms^Xo       , Ms^Xo       , Ha          , Ms^Xo       , Ms^Xo       , Ms          , Ms          , Ha          , Aa          , Ha^Fpa      , Ha^Fpa      , Aa          , Aa          
Aa          , Ms^Xo       , Aa          , Aa          , Aa          , Aa          , Aa          , Aa          , Aa          , Aa          , Ha^Fpa      , Ms          , Ha^Fpa      , Ms^Xo       , Ha^Fpa      , Ha^Xo       , Ha^Xo       , Ha^Fpa      , Ha^Fpa      , Ha^Fpa      , Ms^Xo       , Ms^Xo       , Ms          , Ms^Xo       , Ms          , Ms^Xo       , Ms          , Ms          , Ha          , Ha          , Ce          , Ke          , Ce          , Ha^Fpa      , Aa          , Aa          
Aa^Fpa      , Aa^Fpa      , Ai          , Aa^Fpa      , Aa^Fpa      , Aa^Fpa      , Aa          , Ha          , Ha          , Ms          , Ha^Fpa      , Ha^Fpa      , Ha^Fpa      , Ha^Fpa      , Ha^Fpa      , Ha^Fpa      , Ha^Fpa      , Ms^Xo       , Ms^Xo       , Ms          , Ms^Xo       , Ms          , Ms^Xo       , Ms          , Ms          , Ms          , Ms          , Ha          , Ha          , Ce          , Ce          , Ce          , Aa^Fpa      , Aa          , Aa          , Aa          
Aa^Fpa      , Aa^Fpa      , Ai          , Aa^Fpa      , Aa^Fpa      , Aa^Fpa      , Aa          , Ha          , Ha          , Ms          , Ms          , Ha^Fpa      , Ha^Fpa      , Ha^Fpa      , Ha          , Ha^Fpa      , Ha^Fpa      , Ha^Fpa      , Ha^Fpa      , Ms^Xo       , Ha^Fda      , Ms^Xo       , Ha          , Ms^Xo       , Aa^Fma      , Ha^Vhha     , Ha          , Ha          , Aa          , Rr          , Rr          , Aa^Fpa      , Aa          , Aa          , Aa          , Aa          
Aa^Fpa      , Aa^Fda      , Ai          , Ai          , Aa^Fma      , Aa^Fma      , Aa          , Aa          , Aa          , Ha          , Aa          , Ms          , Ha^Fpa      , Ha^Fpa      , Ha          , Ha          , Ha^Fpa      , Ha^Fpa      , Ha^Fda      , Ha^Fda      , Ha^Fma      , Ha^Fda      , Ha^Fma      , Ha          , Ms          , Ha          , Ha          , Ha          , Aa          , Rr          , Rr          , Aa          , Aa          , Aa          , Aa          , Aa          
Aa^Fpa      , Aa^Fda      , Aa^Fma      , Aa^Fma      , Aa          , Aa^Fma      , Aa          , Aa^Fma      , Aa^Vla      , Aa          , Ha          , Aa          , Aa          , Ha^Fpa      , Ha^Fpa      , Ha          , Ha^Fda      , Ha^Fda      , Ha^Fpa      , Ha^Fda      , Ha^Fma      , Ha^Fma      , Ha^Fma      , Ha^Fma      , Ms          , Ms          , Ms          , Ha          , Aa          , Rr          , Rr          , Aa          , Aa          , Aa          , Aa          , Aa          
Aa^Fpa      , Aa^Fda      , Aa^Fma      , Aa          , Aa^Fma      , Aa          , Aa^Fma      , Aa^Fma      , Ha^Fpa      , Ha          , Ha^Fpa      , Ha          , Ha          , Ha^Fpa      , Ha^Fpa      , Ha^Fpa      , Ha^Fpa      , Ha^Fpa      , Ha^Fpa      , Ha^Fda      , Ha^Fda      , Ha^Fda      , Ha^Fma      , Ms          , Ms          , Ms          , Ms          , Ha          , Aa          , Rr          , Aa^Fma      , Aa          , Aa^Fma      , Aa          , Aa          , Aa          
Aa          , Aa          , Aa          , Aa          , Aa^Fma      , Aa^Fma      , Aa^Fma      , Aa^Fma      , Ha^Fpa      , Ha^Fpa      , Ha^Fpa      , Ha^Fpa      , Ha^Fpa      , Ha^Fpa      , Ha^Fpa      , Ha^Fpa      , Ha^Fpa      , Ha^Fpa      , Ha^Fpa      , Ha^Fpa      , Ms          , Ha^Fma      , Ms          , Ms          , Ha^Vhha     , Ha          , Ha          , Ha          , Aa          , Rr          , Aa^Fma      , Aa^Fma      , Aa^Fma      , Aa^Fma      , Aa          , Aa          
Aa          , Aa          , Aa          , Aa          , Aa^Fma      , Aa^Fma      , Aa^Fma      , Aa^Fma      , Aa          , Aa          , Ha          , Ha^Fpa      , Ms          , Ha^Fpa      , Ms          , Ha^Fpa      , Ha          , Aa          , Aa          , Ha          , Ha          , Ms          , Ms          , Ms          , Ha          , Aa          , Aa          , Aa          , Aa          , Rr          , Aa          , Aa          , Aa          , Aa          , Aa          , Aa          
Aa          , Aa          , Aa          , Aa^Vla      , Aa          , Aa^Fma      , Aa          , Aa^Fma      , Aa          , Ha          , Ha          , Ms          , Ha          , Ms          , Ha          , Ms          , Ha          , Aa          , Aa          , Aa          , Ce          , Ha          , Ha          , Ha          , Ha          , Rr          , Rr          , Aa          , Rr          , Rr          , Aa          , Aa          , Aa          , Aa          , Aa          , Aa          
Ai          , Ai          , Aa          , Aa          , Aa          , Aa          , Aa          , Aa          , Aa          , Aa          , Ha          , Ha          , Ha          , Ha          , Aa          , Ha          , Aa          , Aa          , Ce          , Ce          , 2 Ke        , Ce          , Ce          , Aa          , Rr          , Rr          , Aa          , Rr          , Aa          , Aa          , Aa          , Aa          , Aa          , Aa          , Aa          , Aa          
Aa          , Aa          , Aa^Vla      , Aa          , Aa          , Aa          , Aa          , Aa          , Aa          , Aa          , Aa          , Aa          , Aa          , Aa          , Aa          , Aa          , Aa          , Aa          , Aa          , Ce          , Ce          , Ke          , Ce          , Ce          , Aa^Fma      , Aa^Fma      , Aa^Fma      , Aa          , Aa          , Aa          , Aa          , Aa          , Aa          , Aa          , Aa          , Aa          
Aa          , Aa          , Aa          , Aa          , Aa^Vla      , Aa          , Aa          , Aa          , Aa^Fma      , Aa^Fma      , Aa^Fma      , Aa          , Aa          , Aa          , Aa          , Aa          , Aa^Fma      , Aa^Vca      , Aa^Fma      , Aa          , Aa          , Ce          , Aa          , Aa          , Aa^Fma      , Aa^Fma      , Aa^Fma      , Aa^Fma      , Aa^Fma      , Aa          , Aa          , Aa          , Aa^Fda      , Aa          , Aa          , Aa          
Ai          , Ai          , Aa          , Aa          , Aa          , Aa          , Aa          , Aa^Fma      , Aa^Fma      , Ai          , Aa^Fma      , Aa          , Aa          , Aa          , Aa          , Aa          , Aa^Fma      , Aa^Fma      , Aa^Fma      , Aa          , Rd          , Aa          , Aa          , Rr          , Aa          , Aa^Fma      , Aa^Fma      , Aa^Fma      , Aa^Fma      , Aa          , Aa          , Aa^Fma      , Aa^Fma      , Aa^Fda      , Aa          , Aa          
Ai          , Ai          , Ai          , Aa          , Aa          , Aa          , Aa          , Aa^Fma      , Aa^Fma      , Aa^Fma      , Aa^Fma      , Aa          , Aa          , Aa          , Aa          , Aa          , Aa          , Aa^Fma      , Aa          , Aa          , Rd          , Aa          , Aa          , Rr          , Aa          , Aa          , Aa          , Aa          , Aa          , Aa          , Aa          , Aa^Fma      , Aa^Fma      , Aa^Fda      , Aa          , Aa          
Ai          , Ai          , Ai          , Ai          , Aa          , Aa          , Aa^Fma      , Aa^Fma      , Aa^Fma      , Ai          , Aa^Fma      , Aa^Fma      , Aa^Fma      , Aa          , Aa          , Aa          , Aa          , Aa          , Aa          , Rd          , Aa          , Rd          , Aa          , Aa          , Ai          , Ai          , Ai          , Aa          , Aa          , Aa          , Aa          , Aa          , Aa          , Aa^Fda      , Aa          , Aa          
Ai          , Ai          , Ai          , Ai          , Ai          , Aa          , Aa^Fma      , Aa^Fma      , Aa^Fma      , Aa^Fma      , Ai          , Ai          , Aa^Fma      , Aa          , Aa          , Aa          , Aa          , Rd          , Aa          , Aa          , Ai          , Aa          , Rd          , Aa          , Aa^Vla      , Ai          , Ai          , Ai          , Ai          , Aa          , Aa          , Aa          , Aa          , Aa          , Aa          , Aa          
Ai          , Ai          , Ai          , Ai          , Aa          , Aa          , Aa          , Aa^Fma      , Aa^Fma      , Ai          , Ai          , Aa^Fma      , Re^Gvs      , Re^Gvs      , Aa          , Aa          , Rd          , Rd          , Aa^Vha      , Ai          , Ai          , Aa          , Aa          , Rr          , Aa          , Ai          , Ai          , Ai          , Aa          , Aa          , Aa          , Aa          , Aa          , Aa          , Aa          , Aa          
Ww          , Ww          , Ai          , Ai          , Aa          , Aa          , Aa          , Aa          , Aa          , Aa          , Ai          , Aa          , Aa          , Re^Gvs      , Ai          , Ai^Bw|      , Ai          , Ai          , Ai          , Ai          , Ai          , Ai          , Aa          , Rr          , Rd          , Aa          , Aa          , Aa          , Aa          , Aa          , Aa          , Aa          , Aa^Fpa      , Aa          , Aa          , Aa          
Ww          , Ww          , Ai          , Ai          , Ai          , Aa          , Aa          , Aa          , Ai          , Ai          , Aa^Vla      , Ai          , Ai          , Ai          , Ai          , Ai^Bw|      , Ai          , Ai          , Ai          , Ai          , Ai          , Ai          , Ai          , Rr          , Aa          , Aa          , Aa          , Aa          , Aa          , Aa          , Aa          , Aa^Fpa      , Aa^Fpa      , Aa          , Aa          , Aa          
Ww          , Ww          , Ww          , Ai          , Ai          , Aa          , Aa          , Aa          , Ai          , Ai          , Ai          , Ai          , Ai          , Ai          , Ai          , Ai^Bw|      , Ai          , Ww          , Ww          , Ai          , Ai          , Ai          , Ai^Bw/      , Rd          , Aa          , Aa          , Aa^Fpa      , Aa          , Aa          , Aa          , Aa          , Aa          , Aa          , Aa          , Aa          , Aa          
Ww          , Ww          , Ww          , Ai          , Ai          , Aa          , Aa          , Ai          , Ai          , Ai          , Ai          , Ai          , Ww          , Ww          , Ai          , Ai^Bw|      , Ce          , Ai          , Ai          , Ai          , Ai^Bw/      , Ai^Bw/      , Ai          , Ai          , Ai          , Aa^Fpa      , Aa^Fpa      , Aa^Fpa      , Aa^Fpa      , Aa          , Aa          , Aa          , Aa          , Aa          , Aa          , Aa          
Ww          , Ww          , Ww          , Ai          , Ai          , Ai          , Ai          , Ai          , Ai          , Ai          , Ww          , Ww          , Ai          , Ai          , Ch          , Ce          , Ch          , Ai          , Ai^Bw/      , Ai^Bw/      , Ai          , Ai          , Ai          , Ai          , Ai          , Ai          , Ai          , Aa^Fpa      , Ai          , Aa          , Aa          , Aa          , Aa          , Aa          , Aa          , Aa          
Ww          , Ww          , Ww          , Ai          , Ai          , Ai          , Ai          , Ai          , Ai          , Ai          , Ai          , Ai          , Aa          , Ce          , Aa          , Rr          , Rr          , Ce          , Ch          , Ai          , Ai          , Ww          , Ww          , Ai          , Ai          , Ai          , Ai          , Ai          , Ai          , Ai          , Ai          , Aa          , Ai          , Aa          , Aa          , Aa          
Ww          , Ww          , Ww          , Ai          , Ai          , Ai          , Ai          , Ai          , Ww          , Ww          , Ai          , Ai^Bw\      , Ce          , Ce          , Aa^Vha      , Rr          , Aa^Fda      , Aa          , Aa          , Ce          , Aa          , Ai          , Ai          , Ww          , Ww          , Ai          , Ai          , Ai          , Ai          , Ai          , Ai          , Ai          , Ai          , Ai          , Ai          , Aa          
Ww          , Ww          , Ww          , Ww          , Ai          , Ai          , Ai          , Ai          , Ai          , Ai          , Ai^Bw\      , Aa          , Ce          , Ce          , Rr          , Rr          , Aa          , Aa^Fda      , Aa^Vha      , Ce          , Aa^Vha      , Aa          , Aa^Fda      , Ai          , Ai          , Ai          , Ww          , Ai          , Ai          , Ai          , Ai          , Ai          , Ai          , Ai          , Ai          , Ai          
Ww          , Ww          , Ww          , Ww          , Ai          , Ai          , Ai^Bw\      , Ai          , Ce          , Ai          , Ce          , Ce          , Ce          , Aa^Vha      , Aa          , Rr          , Ce          , Aa          , Aa          , Ce          , Aa          , Aa^Fda      , Aa^Fda      , Ai          , Ai          , Ww          , Ww          , Ww          , Ww          , Ai          , Ai          , Ww          , Ww          , Ww          , Ai          , Ai          
Ww          , Ww          , Ww          , Ww          , Ai          , Ai          , Aa          , Aa          , Ce          , Ce          , Ai          , Ai          , Ch          , Ce          , Ce          , Rr          , Ch          , Rr          , Ce          , Ce          , Ce          , Aa^Vha      , Aa          , Ai          , Ai          , Ai          , Ai          , Ww          , Ww          , Ai          , Ai          , Ai          , Ai          , Ai          , Ai          , Ai          
Ww          , Ww          , Ww          , Ai          , Ai          , Ai          , Aa          , Ce          , Rr          , Aa^Vha      , Aa          , Ai          , Rr          , Rr          , Rr          , Ch          , 3 Kh        , Ch          , Rr          , Aa          , Ce          , Aa          , Ai          , Ai          , Ai          , Ai          , Ai          , Ai          , Ai          , Ai          , Aa          , Ai          , Aa          , Ai          , Aa          , Ai          
Ww          , Ww          , Ww          , Ai          , Ai          , Ai^Bw\      , Aa          , Ce          , Rr          , Rr          , Rr          , Ww^Bw/      , Ch          , Aa          , Ce          , Ch          , Ch          , Ch          , Ce          , Aa^Vea      , Ce          , Aa          , Ai          , Ww          , Ai          , Ai          , Ai          , Ai          , Aa          , Aa          , Aa          , Aa          , Aa          , Aa          , Aa          , Aa          
Ww          , Ww          , Ww          , Ai          , Ai          , Ai          , Aa          , Ce          , Ce          , Aa^Vha      , Aa          , Ai          , Aa          , Ce          , Aa^Vea      , Rr          , Ce          , Rr          , Aa^Fda      , Ce          , Ch          , Ai          , Ww          , Ai          , Ai          , Ai          , Ai          , Aa          , Aa          , Aa          , Aa          , Aa          , Aa          , Aa          , Aa          , Aa          
Ww          , Ww          , Ww          , Ai          , Ai          , Ai^Bw/      , Ai          , Aa          , Aa          , Ce          , Ai          , Ai          , Aa^Fda      , Aa^Fda      , Aa          , Aa          , Aa          , Rr          , Rr          , Ce          , Rr          , Ai          , Ai          , Ai          , Ai          , Ai          , Ai          , Aa          , Aa          , Aa          , Aa          , Aa          , Aa          , Aa          , Aa          , Aa          
Ww          , Ww          , Ww          , Ww          , Ai          , Ai          , Ai          , Ai^Bw/      , Ai          , Ce          , Ai          , Ai          , Ai          , Aa^Fda      , Aa          , Aa^Vea      , Rr          , Rr          , Aa^Vha      , Ce          , Ch          , Ai^Bw\      , Ai^Bw\      , Ai          , Ai          , Ai          , Aa          , Aa          , Aa          , Aa          , Aa          , Aa          , Aa          , Aa          , Aa          , Aa          
Ww          , Ww          , Ww          , Ww          , Ww          , Ai          , Ai          , Ai          , Ai          , Ai          , Ai          , Ww          , Ai^Bw/      , Ce          , Rr          , Rr          , Aa          , Rr          , Aa          , Ce          , Ce          , Ai          , Ai          , Ai          , Ai          , Ai          , Aa          , Aa          , Aa          , Aa          , Aa          , Aa          , Aa^Fpa      , Aa          , Aa          , Aa          
Ww          , Ww          , Ww          , Ww          , Ai          , Ai          , Ai          , Ai          , Ai          , Ai          , Ww^Bw/      , Ai^Bw/      , Ai          , Ce          , Ce          , Aa          , Ch          , Rr          , Ch          , Ce          , Ai          , Ai          , Ai          , Ai          , Ai          , Ai          , Aa          , Aa          , Aa          , Aa          , Aa^Fpa      , Aa^Fpa      , Aa^Fpa      , Aa^Fpa      , Aa^Fpa      , Aa          
Ww          , Ww          , Ww          , Ai          , Ai          , Ai          , Ai          , Ai          , Ai^Bw/      , Ai^Bw/      , Ai          , Ai          , Ai^Bw|      , Ai^Bw/      , Ai          , Ce          , Ai          , Ai^Bw|      , Ai          , Ai          , Ai          , Ai          , Ai          , Ai          , Ai          , Ai          , Ai          , Aa          , Aa          , Aa          , Aa          , Aa^Fpa      , Aa^Fpa      , Aa^Fpa      , Aa^Fpa      , Aa^Fpa      
Ww          , Ww          , Ai          , Ai          , Aa          , Aa          , Aa^Fma      , Ai^Bw/      , Ai          , Ai          , Ai          , Ai          , Ai^Bw|      , Ai          , Ai          , Ai          , Ai          , Ai^Bw|      , Ai          , Ai          , Ai          , Ai          , Ai          , Ai          , Ai          , Ai          , Ai          , Aa          , Aa          , Aa          , Aa          , Aa          , Aa          , Aa          , Aa          , Aa          
Ww          , Ww          , Ai          , Ai          , Aa          , Aa^Fma      , Aa^Fma      , Ai          , Aa          , Ai          , Ai          , Ai          , Ai^Bw|      , Ai          , Ai          , Ai          , Ai          , Ai^Bw|      , Ai          , Ai          , Ai          , Ai          , Aa          , Re          , Ai          , Ai          , Ai          , Aa          , Aa          , Aa          , Aa          , Aa          , Aa          , Aa          , Aa          , Aa          
Ww          , Ww          , Ai          , Ai          , Aa          , Aa^Fma      , Aa^Fma      , Aa^Vha      , Aa          , Aa          , Aa          , Ai          , Aa          , Ai          , Ai          , Ai          , Ai          , Ai^Bw|      , Aa          , Aa          , Aa          , Aa          , Re          , Re          , Aa          , Aa          , Aa          , Aa          , Ai          , Aa          , Aa          , Aa          , Aa          , Aa          , Aa          , Aa          
Ww          , Ww          , Ww          , Ai          , Aa          , Aa          , Aa          , Aa          , Aa          , Aa          , Aa          , Aa          , Aa          , Aa          , Aa          , Aa          , Aa          , Re          , Re          , Aa          , Re          , Re          , Aa          , Aa          , Aa^Vha      , Aa^Fda      , Aa^Fda      , Aa          , Aa          , Aa          , Aa          , Aa          , Aa          , Aa          , Aa          , Aa          
Ww          , Ww          , Ww          , Ai          , Ai          , Aa          , Aa          , Aa          , Aa^Fma      , Aa^Fma      , Aa^Fma      , Aa          , Aa          , Aa          , Aa^Vha      , Aa          , Aa^Fma      , Aa^Fma      , Re          , Re          , Aa          , Aa          , Re^Gvs      , Re^Gvs      , Aa^Fda      , Aa^Fda      , Aa^Fda      , Aa          , Aa^Fda      , Aa          , Aa          , Aa          , Aa          , Aa          , Aa          , Aa          
Ww          , Ww          , Ai          , Ai          , Ww^Bw\      , Aa          , Aa          , Aa^Fma      , Aa^Fma      , Aa^Fma      , Aa^Fma      , Aa          , Aa^Fda      , Aa          , Aa          , Aa          , Aa          , Aa^Fma      , Re          , Aa^Fma      , Aa^Fma      , Aa^Vha      , Re^Gvs      , Re^Gvs      , Aa^Vha      , Aa^Fda      , Aa^Fda      , Aa^Fda      , Aa^Fda      , Aa^Fda      , Aa          , Aa          , Aa          , Aa          , Aa          , Aa          
Ww          , Ww          , Ai          , Ai          , Aa          , Aa          , Aa          , Aa^Vha      , Aa^Fma      , Aa^Fma      , Aa^Fda      , Aa^Fda      , Aa^Fda      , Aa          , Aa          , Aa          , Aa          , Aa          , Re          , Aa^Fma      , Aa^Fma      , Aa^Fma      , Aa          , Aa          , Re^Gvs      , Aa          , Aa          , Aa^Fda      , Aa          , Aa          , Aa          , Aa          , Aa          , Aa          , Aa          , Aa          
Ww          , Ww          , Ai          , Ww^Bw\      , Aa          , Re          , Aa          , Aa^Fma      , Aa          , Aa^Fma      , Aa          , Aa          , Aa          , Aa          , Re          , Re          , Re          , Re          , Re          , Aa          , Aa          , Aa          , Aa          , Re^Gvs      , Re^Gvs      , Aa          , Aa          , Aa          , Aa          , Aa          , Aa          , Aa          , Aa          , Aa          , Aa          , Aa          
Ww          , Ww          , Ai          , Ai          , Aa          , Re          , Re          , Aa          , Re          , Aa          , Re          , Re          , Re          , Re          , Aa          , Aa          , Aa          , Re          , Aa          , Re          , Re          , Re          , Re          , Aa          , Aa          , Aa          , Aa          , Aa          , Aa          , Aa          , Aa          , Aa          , Aa          , Aa          , Aa          , Aa          
Ww          , Ww          , Ai          , Ww^Bw\      , Aa          , Re          , Rr          , Re          , Aa          , Re          , Aa          , Aa          , Aa^Fda      , Aa          , Aa          , Aa          , Aa          , Aa          , Aa          , Aa          , Aa          , Aa^Vha      , Aa          , Re          , Re          , Aa          , Aa          , Aa          , Aa          , Aa          , Aa          , Aa          , Aa          , Aa          , Aa          , Aa          
Ww          , Ww          , Ai          , Ai          , Aa          , Aa^Vha      , Rr          , Aa          , Aa^Fda      , Aa          , Aa^Fda      , Aa^Fda      , Aa^Fda      , Aa          , Aa          , Aa          , Aa          , Aa          , Aa          , Aa          , Aa^Fda      , Aa          , Aa^Fpa      , Aa          , Aa          , Re          , Re          , Aa          , Aa          , Aa          , Aa          , Aa          , Aa          , Aa          , Aa          , Aa          
Ww          , Ww          , Ai          , Ai          , Aa          , Aa          , Rr          , Aa^Fda      , Aa^Fda      , Aa^Fda      , Aa^Fda      , Aa^Fda      , Aa^Fda      , Aa^Fda      , Aa          , Aa          , Aa          , Aa          , Aa          , Aa          , Aa          , Aa^Fda      , Aa^Fpa      , Aa^Fpa      , Aa^Fma      , Aa          , Aa          , Re          , Re          , Aa          , Aa          , Aa          , Aa          , Aa          , Aa          , Aa          
Ww          , Ww          , Ai          , Ai          , Aa          , Aa          , Rr          , Aa^Fda      , Aa^Fda      , Aa^Fda      , Aa^Fda      , Aa^Fda      , Aa^Fda      , Aa^Fda      , Aa          , Aa          , Aa          , Aa          , Aa          , Aa          , Aa          , Aa^Fpa      , Aa^Fpa      , Aa^Fda      , Aa^Fma      , Aa          , Aa          , Re          , Re          , Aa          , Ce          , Aa          , Aa          , Aa          , Aa          , Aa          
