border_size=1
usage=map

Gg          , Gg          , Gg          , Gg          , Gg          , Gg          , Gg          , Gg          , Gg          , Gg          , Gg          , Gg          , Gg          , Gg          , Gg          , Gg          , Ch          , Ch          , Ch          , Ch          , Ch          , Ch          , Ch          , Ch          , Ch          , Gg          , Gg          , Gg          , Gg          , Gg          , Gg^Vh       , Gg          , Gg          , Gg          , Gg          , Gg          , Rp          , Rp          
Gg          , Gg          , Gg          , Gg          , Gg          , Gg          , Gg          , Gg          , Gg          , Gg^Eff      , Gs^Eff      , Gs          , Gg          , Gg          , Gg          , Gg          , Ch          , Kh          , Ch          , Ch          , Ch          , Ch          , Ch          , 2 Kh        , Ch          , Gg          , Gg          , Gg          , Re^Gvs      , Re^Gvs      , Re^Gvs      , Gg          , Gg^Eff      , Gg^Eff      , Rp          , Rp          , Gg          , Gg          
Gg          , Gg          , Gg          , Gg          , Gg          , Gg          , Re^Gvs      , Re^Gvs      , Re^Gvs      , Gg          , Gg          , Gs^Eff      , Gg^Eff      , Gg          , Gg          , Gg          , Gg          , Ch          , Gg^Fet      , Rr^Vhc      , Rr          , Rr^Vhc      , Gg^Fet      , Ch          , Gg          , Gg          , Re^Gvs      , Re^Gvs      , Re^Gvs      , Re^Gvs      , Gg          , Gg^Eff      , Rp          , Rp          , Rp          , Rp          , Gg          , Gg          
Gg          , Gg          , Gg          , Gg          , Re^Gvs      , Re^Gvs      , Re^Gvs      , Re^Gvs      , Re^Gvs      , Re^Gvs      , Re^Gvs      , Gg          , Gg          , Gg^Eff      , Gg^Eff      , Gg          , Gg          , Gg          , Gg^Fet      , Ggf         , Rr          , Ggf         , Gg^Fet      , Gg          , Gg          , Re^Gvs      , Re^Gvs      , Gg^Wm       , Gg          , Gg          , Gg          , Rp          , Rp          , Rp          , Gg^Eff      , Gg          , Gg          , Gg          
Gg          , Gg          , Gg          , Re^Gvs      , Re^Gvs      , Re^Gvs      , Re^Gvs      , Gg^Vh       , Re^Gvs      , Re^Gvs      , Re^Gvs      , Re^Gvs      , Re^Gvs      , Gg          , Gg          , Gg^Eff      , Gg^Eff      , Gg          , Gg^Fet      , Ggf         , Rr          , Ggf         , Gg^Fet      , Gg          , Gg          , Gg          , Gg          , Gg          , Gs          , Gg          , Rp          , Rp          , Rp          , Gg          , Gs          , Gg^Eff      , Gg^Eff      , Gg          
Gg          , Gg          , Gg          , Gg          , Gg          , Re^Gvs      , Re^Gvs      , Re^Gvs      , Re^Gvs      , Gg^Wm       , Re^Gvs      , Re^Gvs      , Re^Gvs      , Re^Gvs      , Re^Gvs      , Gg          , Gg          , Gg          , Gg^Fet      , Ggf         , Rr          , Ggf         , Gg^Fet      , Gg          , Gg          , Gg          , Gs          , Gs          , Gs          , Gg          , Rp          , Rp          , Gg          , Gg          , Gg          , Gs          , Gg          , Gg^Eff      
Gg          , Gg          , Gs          , Gs          , Gs          , Gg          , Gg          , Re^Gvs      , Re^Gvs      , Re^Gvs      , Re^Gvs      , Gg^Vh       , Re^Gvs      , Re^Gvs      , Re^Gvs      , Re^Gvs      , Gs          , Gg          , Gg          , Gg          , Rr          , Ggf         , Ggf         , Ggf         , Gg          , Gg          , Gg          , Gs          , Gg          , Rp          , Rp          , Rp          , Gg          , Gg          , Gg^Vh       , Gg          , Re^Gvs      , Gg          
Gg          , Gg          , Gs          , Gs          , Gs          , Gg          , Gg^Eff      , Gg          , Gg          , Re^Gvs      , Re^Gvs      , Re^Gvs      , Re^Gvs      , Re^Gvs      , Gg          , Gg          , Gg          , Gs          , Gg^Eff      , Gg^Eff      , Rr          , Gg^Eff      , Gg^Eff      , Re^Gvs      , Re^Gvs      , Gg^Vh       , Gg          , Gg          , Gg          , Rp          , Rp          , Gg          , Gg          , Gg          , Re^Gvs      , Re^Gvs      , Re^Gvs      , Gg          
Gs          , Gg          , Gs          , Gs          , Gs          , Gs          , Gs          , Gg^Eff      , Gg^Eff      , Gg          , Gg          , Re^Gvs      , Gg          , Gg          , Gg          , Gg          , Gg^Eff      , Gg^Eff      , Gg          , Gg          , Rr          , Gg          , Gg          , Re^Gvs      , Re^Gvs      , Re^Gvs      , Re^Gvs      , Gg          , Gg          , Rp          , Rp          , Gg          , Re^Gvs      , Re^Gvs      , Re^Gvs      , Re^Gvs      , Gg          , Gg          
Gg          , Gs          , Gs          , Gs          , Gs          , Gs          , Gs          , Gs          , Gs          , Gg^Eff      , Gg^Eff      , Gg          , Gg          , Gg          , Gg^Eff      , Gg^Eff      , Gg          , Gg          , Rr          , Rr          , Gg          , Gg          , Gs          , Gg          , Gg          , Re^Gvs      , Gg          , Gg          , Rp          , Rp          , Rp          , Gg          , Gg          , Re^Gvs      , Gg^Wm       , Gg          , Gg          , Gg          
Gs          , Gs          , Gs          , Gs          , Gs          , Gs          , Gs          , Gs          , Gs          , Gs          , Gg          , Gg^Eff      , Gg^Eff      , Gg^Eff      , Rp          , Rp          , Rp          , Rr          , Gg          , Gg          , Gs          , Gs          , Gs          , Gs          , Gs          , Gg          , Gg          , Gg          , Rp          , Rp          , Rd          , Gg^Eff      , Gg^Eff      , Gg          , Gs          , Gg          , Gg^Eff      , Gg          
Gs          , Gs          , Gs          , Gs          , Gs          , Gs          , Gs          , Gs          , Gs          , Gs          , Gg^Eff      , Gg^Eff      , Rp          , Rp          , Rp          , Rp          , Rp          , Rp          , Rp          , Gg          , Gg          , Gs          , Gg          , Gs          , Gg          , Gg          , Gg          , Rp          , Rp          , Rp          , Gs          , Gs          , Gs          , Gg^Eff      , Gs^Eff      , Gs^Eff      , Gg          , Gg          
Gg          , Gs          , Gs          , Gs          , Gs          , Gs          , Gs          , Gs          , Gg^Eff      , Gg^Eff      , Gg          , Rp          , Rp          , Rp          , Gg          , Gg          , Gg          , Rp          , Rp          , Rp          , Rp          , Gg          , Gg          , Gg          , Gg          , Gg          , Rp          , Rp          , Rp          , Gg          , Gg          , Gs          , Gg^Eff      , Gg^Eff      , Gg          , Gg          , Gg          , Gg          
Gg          , Gs          , Gs          , Gs          , Gs          , Gs          , Gs          , Gg          , Gg          , Gg^Eff      , Gg^Eff      , Rp          , Rp          , Gg          , Gg          , Gs          , Gg          , Gg          , Gg          , Rp          , Rp          , Rp          , Rp          , Rp          , Rp          , Rp          , Rp          , Rp          , Gg          , Gg          , Gg^Eff      , Gg^Eff      , Re^Gvs      , Re^Gvs      , Re^Gvs      , Gg          , Gg          , Gg          
Gg          , Gs          , Gs          , Gs          , Gs          , Gs          , Gg          , Gg          , Gg^Eff      , Gg^Eff      , Rp          , Rp          , Rp          , Gg          , Gg          , Gs          , Gg          , Gg          , Gg          , Gg          , Gg          , Rp          , Rp          , Rp          , Rp          , Rp          , Gg          , Gg          , Gg^Eff      , Gg^Eff      , Re^Gvs      , Re^Gvs      , Re^Gvs      , Gg^Vh       , Re^Gvs      , Re^Gvs      , Re^Gvs      , Gg          
Gg          , Gg          , Gs          , Gs          , Gg          , Gg          , Gg^Eff      , Gg^Eff      , Rp          , Rp          , Rp          , Rp          , Gg          , Gg          , Gg          , Gg          , Re^Gvs      , Re^Gvs      , Re^Gvs      , Gg          , Gg          , Gg          , Gg          , Gg^Vh       , Gg          , Gg          , Gg^Eff      , Gg^Eff      , Gg^Eff      , Gg          , Gg          , Re^Gvs      , Re^Gvs      , Re^Gvs      , Re^Gvs      , Re^Gvs      , Re^Gvs      , Re^Gvs      
Gg          , Gg          , Gg          , Gg          , Gg^Eff      , Gg^Eff      , Gg          , Rp          , Rp          , Rp          , Gg          , Gg          , Gg          , Gg          , Re^Gvs      , Re^Gvs      , Re^Gvs      , Re^Gvs      , Gg          , Gg          , Gg^Eff      , Gg^Eff      , Gg          , Re^Gvs      , Re^Gvs      , Gg^Eff      , Gg          , Gg          , Gg          , Gg^Eff      , Gg^Eff      , Gg          , Gg          , Re^Gvs      , Re^Gvs      , Re^Gvs      , Re^Gvs      , Re^Gvs      
Gg          , Gg          , Gg^Eff      , Gg^Eff      , Gg          , Gg          , Rp          , Rp          , Rp          , Gg          , Gg          , Gg          , Gg          , Gg          , Gg^Wm       , Re^Gvs      , Gg          , Gg          , Gs^Eff      , Gg^Eff      , Gs          , Gg          , Gg          , Re^Gvs      , Re^Gvs      , Gg          , Gg          , Gg          , Gs          , Gs          , Gs          , Gs^Eff      , Gs^Eff      , Gg          , Gg          , Re^Gvs      , Gg          , Gg          
Gg          , Gg          , Gg          , Gg          , Rp          , Rp          , Rp          , Rp          , Ce          , Gg          , Gg          , Gg          , Gs          , Gg          , Gg          , Gg          , Gg          , Gg^Eff      , Gs          , Gs          , Gg          , Gg          , Gg          , Re^Gvs      , Re^Gvs      , Gg          , Gg          , Gg          , Gs          , Gs          , Gs          , Gs          , Gs          , Gs^Eff      , Gg^Eff      , Gg          , Gg          , Gg          
Gg          , Gg          , Rp          , Rp          , 1 Rp        , Rp          , Gg          , Ce          , Ke          , Gg^Vh       , Gg          , Gg          , Gs          , Gs          , Gs          , Gg          , Gg          , Gg          , Gs          , Gg          , Gg          , Gg          , Gg          , Re^Gvs      , Re^Gvs      , Gg          , Gg          , Gs          , Gs          , Gg          , Gg          , Gs          , Gg          , Gs          , Gg          , Gg^Eff      , Gg          , Gg          
Rp          , Rp          , Rp          , Rp          , Gg          , Gg          , Gg          , Gg          , Gg          , Gg          , Gg          , Gg          , Gg          , Gg          , Gg          , Gg          , Gg          , Gg          , Gg          , Gs          , Gg          , Gg          , Gg          , Re^Gvs      , Re^Gvs      , Gg          , Gg          , Gg          , Gg          , Gg          , Gg          , Gg          , Gg          , Gg          , Gg          , Gg          , Gg          , Gg          
Rp          , Rp          , Gg          , Gg          , Gg          , Gg          , Gg          , Gg          , Gg          , Gg          , Gg          , Gg          , Gg          , Gg          , Gg          , Gg          , Gg          , Gg          , Gg          , Gg          , Gg          , Gg          , Gg          , Re^Gvs      , Gg          , Gg          , Gg          , Gg          , Gg          , Gg          , Gg          , Gg          , Gg          , Gg          , Gg          , Gg          , Gg          , Gg          
