border_size=1
usage=map

Gs^Fms      , Gs^Fms      , Gs^Fms      , Gs^Fms      , Gg          , Hh          , Hh          , Hh          , Hh          , Mm          , Hh          , Mm          , Mm          , Mm          , Mm          , Hh          , Hh          , Mm          , Mm          , Mm          , Mm          , Mm          , Mm          , Mm          , Mm          , Mm          , Hh          , Mm          , Mm          , Mm          , Mm          , Hh^Fds      , Hh^Fds      , Hh^Fds      , Gg          , Gg          , Gs^Fds      , Gs^Fds      , Gg          , Gs^Fds      , Gs^Fds      , Gs^Fms      
Gs^Fms      , Gs^Fms      , Gs^Fds      , Gs^Fds      , Gg          , Hh          , Hh          , Hh          , Hh          , Mm          , Hh          , Mm          , Mm          , Mm          , Mm          , Hh          , Hh          , Mm          , Mm          , Mm          , Mm          , Mm          , Mm          , Mm          , Mm          , Mm          , Hh          , Mm          , Mm          , Mm          , Mm          , Hh^Fds      , Hh          , Hh^Fds      , Gg          , Gg          , Gs^Fds      , Gs^Fds      , Gg          , Gs^Fds      , Gs^Fms      , Gs^Fms      
Gs^Fms      , Gs^Fms      , Gg          , Gg          , Gg          , Hh          , Hh          , Hh          , Hh          , Mm          , Mm          , Mm          , Mm          , Hh          , Mm          , Mm          , Mm          , Mm          , Hh          , Mm          , Mm          , Mm          , Hh          , Mm          , Hh          , Hh          , Hh^Vhh      , Hh          , Mm          , Mm          , Mm          , Mm          , Hh          , Hh          , Hh          , Gg          , Gg          , Gs^Fms      , Gs^Fds      , Gs^Fms      , Gs^Fds      , Gs^Fms      
Gs^Fds      , Gs^Fms      , Gg          , Gg          , Gg          , Hh          , Hh          , Hh          , Hh          , Hh          , Hh          , Hh          , Mm          , Mm          , Mm          , Mm          , Hh          , Mm          , Mm          , Mm          , Mm          , Hh          , Mm          , Mm          , Hh          , Hh          , Gg          , Hh          , Hh          , Mm          , Hh          , Mm          , Mm          , Hh          , Gg          , Gg          , Gg          , Gs^Fms      , Gg          , Gg          , Gs^Fms      , Gs^Fms      
Gs^Fds      , Gs^Fds      , Gg          , Gg          , Gg          , Gg          , Hh          , Hh          , Gg          , Hh          , Hh          , Hh          , Mm          , Hh          , Mm          , Hh          , Mm          , Hh          , Mm          , Mm          , Mm          , Hh          , Hh          , Hh          , Hh          , Hh          , Hh          , Hh          , Hh^Fds      , Hh^Fds      , Hh          , Hh          , Hh          , Hh          , Hh          , Hh          , Gg          , Gg          , Gg          , Gg          , Gg          , Gg          
Gg          , Gg          , Gg          , Gg^Vh       , Gg          , Gg          , Ggf         , Gg          , Gg          , Hh          , Hh          , Hh          , Mm          , Mm          , Mm          , Hh          , Hh          , Mm          , Mm          , Mm          , Mm          , Mm          , Hh          , Hh          , Hh          , Hh          , Gg          , Hh          , Gs^Fds      , Gs^Fds      , Gg          , Hh          , Hh          , Hh          , Hh          , Gg^Vh       , Gs          , Gg          , Gs          , Gg          , Gg          , Gg          
Gg          , Gg          , Gg          , Gg          , Gg          , Gg          , Ggf         , Ggf         , Gg          , Hh          , Hh          , Hh          , Mm          , Mm          , Mm          , Mm          , Mm          , Mm          , Mm          , Mm          , Mm          , Hh          , Hh          , Hh          , Gg          , Gg          , Gg          , Gg          , Gg          , Gs^Fds      , Gs          , Gg          , Gs          , Hh          , Gs          , Gs          , Gs          , Gs          , Re          , Gg          , Re          , Re          
Re          , Re          , Re          , Gg          , Gg          , Gg          , Gg          , Gg          , Gs^Fds      , Gg          , Hh^Fms      , Hh          , Hh          , Mm          , Mm          , Hh          , Hh          , Gg^Vh       , Mm          , Mm          , Hh          , Hh          , Hh          , Hh          , Hh          , Gg          , Gg          , Gg          , Gs          , Gg          , Gg          , Gs          , Gs          , Gs          , Gs          , Ss          , Re          , Re          , Gs          , Re          , Gs          , Gs          
Gg          , Ggf         , Gg          , Re          , Re          , Gg          , Gg          , Gg          , Gs^Fms      , Hh^Fms      , Hh^Fms      , Hh          , Hh          , Hh          , Hh          , Hh          , Hh          , Hh          , Hh          , Hh          , Hh          , Hh          , Hh          , Hh          , Hh          , Gg          , Gg          , Gg          , Gg          , Gs          , Gs          , Gs          , Gs          , Gs          , Re          , Re          , Re          , Gs          , Gs          , Gs          , Gs          , Gs          
Gg          , Ggf         , Ggf         , Gg          , Gg          , Re          , Re          , Gg          , Gg          , Hh^Fms      , Hh          , Hh          , Hh          , Hh          , Hh          , Hh          , Hh          , Hh          , Gg^Vh       , Hh          , Hh          , Hh          , Gg          , Hh          , Gg          , Gg          , Hh          , Hh          , Hh          , Gs          , Gs          , Gs          , Re          , Re          , Re          , Ch          , Chr         , Re          , Gs          , Gs          , Gg          , Gg          
Gg          , Gg          , Gg          , Gg          , Ce          , Gg          , Gg          , Re          , Gg          , Gg          , Gg          , Hh          , Gg          , Hh          , Hh          , Hh          , Hh          , Hh          , Hh          , Gg          , Gg          , Gg          , Gg          , Gg          , Gg          , Gg          , Hh          , Hh          , Gg^Vh       , Hh          , Gs          , Re          , Re          , Re          , Ch          , 2 Kh        , Re          , Re          , Gs          , Gs          , Gs          , Gs          
Gg          , Gg          , Gg          , Ce          , 1 Ke        , Ce          , Gg          , Re          , Re          , Gg          , Gg          , Gg          , Gg^Vh       , Gg          , Hh          , Hh          , Hh          , Hh          , Hh          , Hh          , Hh          , Gg          , Gg          , Gg          , Gg          , Hh          , Hh          , Hh          , Hh          , Gs          , Gs          , Re          , Re          , Re          , Re          , Chr         , Re          , Gs          , Gg          , Gg          , Gg          , Gg          
Gg          , Gg          , Gg          , Ce          , Ce          , Ce          , Gg          , Gg          , Gg          , Re          , Re          , Gg          , Hh          , Hh          , Hh          , Hh          , Mm          , Mm          , Hh          , Hh          , Hh          , Gg          , Gg          , Gg          , Gg          , Gg          , Hh          , Hh          , Gs          , Gs          , Re          , Re          , Gs          , Gs          , Hh          , Re          , Gs          , Gs          , Gg^Vh       , Gs^Fds      , Gg          , Gg          
Gg          , Gg          , Gg          , Gg          , Gg          , Gg          , Ggf         , Gg          , Gg          , Gg          , Re          , Gg          , Gs^Fms      , Hh          , Hh          , Hh          , Mm          , Mm          , Hh          , Hh          , Hh          , Hh          , Gg          , Gg          , Gg          , Gg          , Re          , Re          , Re          , Re          , Gg          , Gs          , Gs          , Gs          , Hh          , Hh          , Gs          , Gs          , Gs^Fds      , Gs^Fds      , Gs^Fms      , Gs^Fms      
Gg          , Gg          , Gg          , Gg          , Gg          , Gg          , Gg          , Ggf         , Gg          , Gg          , Gg          , Re          , Gs^Fms      , Hh          , Hh          , Hh          , Hh          , Hh          , Hh          , Hh          , Gg          , Gg          , Re          , Re          , Re          , Re          , Gg          , Gg          , Hh          , Hh          , Gg^Vh       , Gg          , Gs          , Ss          , Ss          , Gs          , Gs          , Gg          , Gs^Fms      , Gs^Fms      , Gs^Fms      , Gs^Fms      
Gg          , Gg          , Gg          , Gg^Vh       , Gs^Fds      , Gg          , Gg          , Ggf         , Gg          , Hh          , Hh          , Re          , Re          , Hh^Fms      , Gg          , Hh          , Hh          , Hh          , Gg          , Gg          , Re          , Re          , Gs^Fds      , Gs^Fds      , Hh          , Gg          , Hh          , Hh          , Hh          , Hh          , Gg          , Gg          , Gs          , Ss          , Gs          , Gs          , Gs          , Gg          , Gg          , Gs^Fms      , Gs^Fms      , Gs^Fms      
Hh^Fms      , Gs^Fds      , Gs^Fms      , Gs^Fms      , Gs^Fds      , Gs^Fms      , Gg          , Gg          , Gg          , Hh          , Gg          , Gg          , Gg          , Re          , Re          , Gg          , Gg          , Gg          , Re          , Re          , Hh          , Hh          , Hh          , Hh          , Hh          , Hh          , Hh^Fds      , Hh          , Hh          , Gg          , Hh          , Gs          , Hh          , Gs          , Hh          , Gs          , Hh          , Gg          , Gg          , Gg          , Gg          , Gg          
Hh^Fms      , Hh^Fms      , Hh^Fms      , Gg          , Hh          , Gs^Fds      , Gs^Fms      , Gg          , Gg          , Gg          , Ss          , Gg          , Gg          , Gg          , Gg          , Re          , Re          , Re          , Gg          , Gg          , Hh          , Hh          , Gg          , Hh          , Hh          , Hh^Fds      , Hh          , Hh          , Hh          , Hh          , Hh          , Gs          , Hh          , Hh          , Hh          , Hh          , Hh          , Hh          , Hh          , Hh          , Hh          , Hh          
Hh          , Hh          , Hh          , Hh          , Hh          , Hh^Fms      , Gs^Fms      , Gs^Fms      , Gs^Fp       , Ss          , Ss          , Ss          , Gs^Fp       , Hh^Fms      , Hh          , Gg          , Re          , Gg          , Hh          , Hh          , Hh          , Hh          , Hh          , Hh          , Gg          , Hh          , Gg          , Hh          , Hh          , Hh          , Hh          , Hh          , Hh          , Hh          , Hh          , Hh          , Hh          , Hh          , Hh          , Hh^Fds      , Hh^Fds      , Hh          
Hh          , Hh          , Hh          , Hh          , Hh          , Hh^Fms      , Hh          , Gs^Fms      , Gs^Fp       , Gg          , Gs^Fp       , Ss          , Gs^Fp       , Gs^Fms      , Hh          , Gg          , Re          , Gg          , Gg          , Hh          , Hh          , Hh          , Hh          , Hh          , Gg          , Gg          , Gg          , Hh          , Hh          , Hh          , Hh          , Hh          , Hh          , Hh          , Hh          , Hh          , Hh          , Hh          , Hh          , Hh^Fds      , Hh          , Hh          
Hh          , Hh          , Hh          , Hh          , Hh          , Hh          , Hh          , Hh          , Hh          , Gs^Fp       , Hh          , Gs^Fp       , Hh          , Hh          , Hh          , Hh          , Re          , Gg          , Gg          , Hh          , Hh          , Hh          , Hh^Fds      , Hh          , Hh          , Gg          , Gg^Vh       , Hh          , Hh          , Hh          , Hh          , Hh          , Hh          , Hh          , Hh          , Hh          , Gg          , Hh          , Hh          , Hh          , Hh          , Hh          
Hh          , Hh          , Hh          , Hh          , Hh          , Gg          , Gg          , Gg          , Gg          , Hh          , Hh          , Hh          , Gg^Vh       , Hh          , Hh^Fms      , Hh          , Re          , Gg          , Hh          , Hh          , Hh          , Hh          , Hh          , Hh          , Hh          , Hh          , Hh          , Hh          , Hh          , Hh          , Hh          , Hh          , Gg^Vh       , Hh          , Hh          , Hh          , Hh          , Hh          , Hh          , Gg          , Gg          , Gg          
Hh          , Hh          , Hh          , Hh          , Hh          , Hh          , Gg^Vh       , Gg          , Hh          , Hh          , Hh          , Hh          , Gg          , Hh          , Hh          , Gg          , Re          , Gg          , Gg          , Hh          , Hh          , Hh          , Gg          , Hh          , Hh          , Hh          , Hh          , Hh          , Hh          , Hh          , Hh          , Gg          , Hh          , Gg          , Hh          , Hh          , Hh          , Hh          , Gg          , Gg          , Hh          , Hh          
Hh^Fms      , Hh^Fms      , Gs^Fms      , Hh          , Hh          , Hh          , Hh          , Hh          , Hh          , Hh          , Hh^Fds      , Hh          , Hh          , Hh          , Hh          , Gs^Fms      , Gs          , Re          , Re          , Gs          , Hh          , Hh          , Hh          , Hh          , Gg          , Hh          , Hh          , Hh          , Hh          , Hh          , Hh          , Hh          , Hh          , Hh          , Hh          , Hh          , Hh          , Hh          , Hh          , Gg          , Hh          , Hh          
Gg          , Gg          , Gs^Fms      , Gs^Fms      , Hh          , Hh          , Hh          , Hh          , Hh^Fds      , Hh          , Hh          , Hh          , Hh          , Hh          , Hh          , Gs^Fms      , Hh          , Gs          , Re          , Gs          , Hh          , Hh          , Hh          , Hh          , Hh          , Hh          , Hh          , Hh          , Hh          , Hh          , Hh          , Hh          , Hh          , Hh          , Hh          , Hh          , Hh^Fms      , Hh^Fms      , Hh          , Hh          , Hh          , Hh          
Gs^Fms      , Gs^Fms      , Gs^Fms      , Gg          , Gg          , Hh          , Gg          , Hh          , Gs^Fds      , Gs^Fds      , Gs^Fds      , Hh          , Hh          , Hh          , Hh          , Hh          , Hh          , Hh          , Re          , Gs          , Gs          , Hh          , Hh          , Hh          , Hh          , Hh          , Hh          , Hh          , Hh          , Gg          , Gg          , Hh          , Hh          , Hh          , Hh          , Hh          , Hh          , Hh          , Hh          , Hh          , Hh          , Hh          
Gs^Fms      , Gs^Fms      , Gs^Fms      , Ss          , Ss          , Gg          , Gg          , Gg          , Gg          , Gs^Fds      , Hh^Fds      , Gg          , Hh          , Hh          , Hh          , Hh          , Gg^Vh       , Hh          , Gs          , Re          , Re          , Re          , Hh          , Hh          , Hh          , Hh          , Hh          , Gg          , Gg          , Gg          , Gg          , Hh          , Hh^Vhh      , Hh          , Hh          , Gg          , Gg          , Hh          , Hh          , Hh          , Hh          , Hh          
Gs^Fms      , Gs^Fms      , Ss          , Ss^Vhs      , Ss          , Gg          , Gg          , Gg          , Gg          , Gg          , Gg          , Hh          , Gg          , Gg          , Gg          , Hh          , Gg          , Gs          , Hh          , Re          , Chr         , Re          , Ss          , Hh          , Hh^Fms      , Hh^Fms      , Gs^Fms      , Gg          , Gs          , Gg          , Gs          , Gg          , Gg          , Hh          , Hh          , Hh          , Hh          , Hh          , Hh          , Gg^Vh       , Hh          , Hh^Fms      
Gs^Fms      , Gs^Fms      , Gs^Fms      , Ss          , Ss          , Gg          , Gg          , Gg          , Hh          , Hh          , Gg          , Gg          , Gg          , Gg          , Gg          , Gg          , Gg          , Hh          , Hh          , Chr         , 3 Kh        , Re          , Re          , Hh          , Hh          , Gs^Fms      , Gs^Fms      , Gg          , Gg          , Gs          , Ss          , Gs          , Gs          , Hh          , Hh          , Hh          , Gg          , Hh          , Gg          , Gg          , Hh^Fms      , Hh^Fms      
Gs^Fms      , Gs^Fms      , Gs^Fms      , Ss          , Gs^Fms      , Gg          , Gg          , Hh^Vhh      , Hh          , Hh          , Hh          , Gg          , Gg          , Gg          , Gg          , Gg          , Gg          , Hh          , Hh          , Hh          , Ch          , Ch          , Re          , Re          , Re          , Gg^Vh       , Gg          , Gg          , Gg          , Gg          , Gs          , Gs          , Gg          , Gg          , Gg          , Hh          , Gg          , Gg          , Hh^Fms      , Hh^Fms      , Hh^Fms      , Hh^Fms      
Gs^Fms      , Gs^Fms      , Gs^Fms      , Ss          , Gs^Fms      , Gg          , Gs^Fds      , Gg          , Hh          , Hh          , Gg          , Gg          , Gs^Fms      , Gs^Fms      , Gs^Fp       , Gg          , Gg          , Gg          , Hh          , Hh          , Hh          , Hh          , Hh          , Gs          , Gs          , Re          , Re          , Gg          , Gg          , Gg          , Gg          , Gs          , Gg          , Gg          , Gs^Fms      , Gg          , Gs^Fms      , Gs^Fms      , Gs^Fms      , Gs^Fms      , Gs^Fms      , Gs^Fms      
Gs^Fms      , Gs^Fms      , Gs^Fms      , Ss          , Gs^Fms      , Gs^Fms      , Gs^Fds      , Gs^Fds      , Hh          , Hh          , Gg          , Gg          , Gs^Fms      , Gs^Fp       , Gs^Fp       , Gg          , Gg          , Gg          , Hh          , Hh          , Hh          , Hh          , Hh          , Gs          , Gs          , Re          , Re          , Gg          , Gg          , Gg          , Gg          , Gs          , Gg          , Gs^Fms      , Gs^Fms      , Gs^Fms      , Gs^Fms      , Gs^Fms      , Gs^Fms      , Gs^Fms      , Gs^Fms      , Gs^Fms      
