border_size=1
usage=map

Ms          , Ms          , Ms          , Ms          , Ms          , Aa          , Ms          , Aa          , Ms          , Ms          , Ms          , Ms          , Ms          , Aa          , Ms          , Aa          , Mm          , Ha          , Ha^Fpa      , Aa          , Ms          , Aa          , Ms          , Ms          , Ms          , Ms          , Ms          , Ha          , Ha          , Gs          , Aa^Fpa      , Aa^Fpa      , Ha          , Ha^Fpa      , Mm          , Mm          , Mm          , Ha          , Ha          , Aa          , Aa          , Aa          
Ms          , Ms          , Ms          , Ms          , Ms          , Ms          , Ms          , Ms          , Ms          , Ms          , Ms          , Ms          , Ms          , Ms          , Ms          , Ms          , Mm          , Ha          , Ha^Fpa      , Aa          , Aa          , Ms          , Ha          , Ha^Vhha     , Ms          , Ms          , Mm          , Ha          , Ha          , Ha          , Aa^Fpa      , Aa^Fpa      , Ha^Fpa      , Ha^Fpa      , Mm          , Mm          , Coa         , Ha          , Ha          , Aa          , Aa          , Aa          
Ms          , Ms          , Ms          , Ms          , Ms          , Ms          , Ms          , Ms          , Ms          , Aa          , Ms          , Ms          , Ms          , Ms          , Mm          , Mm          , Aa          , Rrc         , Rrc         , Rrc         , Ms          , Ms          , Ms          , Ms          , Mm          , Ms          , Ms          , Mm          , Mm          , Ha          , Ha          , Aa^Vha      , Mm          , Ha          , Coa         , Coa         , 1 Koa       , Coa         , Coa         , Ha          , Ha          , Ha          
Ms          , Mm          , Ms          , Ms          , Ms          , Ms          , Ms          , Ms          , Mm          , Ms          , Mm          , Aa          , Ms          , Mm          , Ha          , Ha          , Ha          , Ha          , Ha          , Ha          , Ha          , Ms          , Ha          , Mm          , Mm          , Mm          , Ha          , Mm          , Ha          , Ha          , Ha          , Ha          , Ha          , Mm          , Coa         , Koa         , Koa         , Koa         , Coa         , Mm          , Mm          , Mm          
Ms          , Mm          , Ms          , Ms          , Rrc         , Ms          , Mm          , Mm          , Ha          , Ha          , Ms          , Ms          , Mm          , Ha          , Ha          , Mm          , Mm          , Mm          , Mm          , Mm          , Ha          , Ha          , Aa          , Ha          , Ha          , Mm          , Ha          , Ha          , Ha          , Ha          , Ha          , Ha          , Ha          , Mm          , Mm          , Coa         , Coa         , Koa         , Coa         , Mm          , Ha          , Ha          
Ms          , Ms          , Ms          , Mm          , Rrc         , Mm          , Mm          , Mm          , Ha          , Rrc         , Cea         , Cea         , Cea         , Mm          , Mm          , Mm          , Mm          , Ha          , Ha          , Ha          , Aa          , Rrc         , Rrc         , Aa          , Ha          , Mm          , Ha          , Aa          , Aa^Fpa      , Aa^Fpa      , Ha          , Ha          , Mm          , Mm          , Mm          , Mm          , Coa         , Coa         , Ha          , Ha          , Ha          , Aa          
Ms          , Ms          , Mm          , Mm          , Ms          , Rrc         , Rrc         , Mm          , Mm          , Mm          , Cea         , 3 Kea       , Kea         , Cea         , Ms          , Mm          , Mm          , Ha          , Rrc         , Rrc         , Aa          , Aa          , Aa^Fpa      , Aa          , Rrc         , Ha          , Rrc         , Aa          , Aa^Fpa      , Aa^Fpa      , Ha          , Mm          , Mm          , Mm          , Ha          , Ha          , Mm          , Ha          , Ha          , Aa^Vha      , Ha          , Aa          
Mm          , Mm          , Ha          , Ms          , Ha^Fpa      , Ms          , Ms          , Ms          , Mm          , Ha          , Ha          , Cea         , Cea         , Cea         , Ms          , Ha          , Mm          , Ha          , Ha          , Aa          , Aa          , Rrc         , Rrc         , Aa^Fpa      , Aa^Fpa      , Rrc         , Aa^Fpa      , Aa^Fpa      , Aa^Fpa      , Aa^Fpa      , Aa^Fpa      , Ha          , Ha          , Ha          , Rrc         , Ha          , Ha          , Mm          , Ha^Fpa      , Aa          , Aa          , Aa          
Ha          , Ha          , Ha          , Ms          , Ms          , Aa^Fpa      , Rrc         , Aa^Vha      , Ha          , Mm          , Ha          , Re          , Ms          , Ms          , Aa^Fpa      , Ha          , Ha          , Ha          , Mm          , Ha          , Ha          , Rrc         , Rrc         , Aa^Fpa      , Aa^Fpa      , Aa^Fpa      , Aa^Fpa      , Aa^Fpa      , Aa^Fpa      , Aa^Fpa      , Aa^Fpa      , Aa^Vha      , Ha          , Aa          , Aa          , Aa          , Aa          , Ha          , Aa          , Aa^Fpa      , Aa^Fpa      , Aa^Fpa      
Ha          , Ha          , Mm          , Ha          , Aa          , Ms          , Ms          , Rrc         , Rrc         , Ha          , Rrc         , Ms          , Aa^Fpa      , Ha^Fpa      , Aa^Fpa      , Aa          , Ha          , Ha          , Mm          , Mm          , Mm          , Ha          , Rrc         , Rrc         , Rrc         , Rrc         , Aa^Fpa      , Aa^Fpa      , Aa^Fpa      , Rrc         , Rrc         , Ha          , Mm          , Ha          , Rrc         , Ha^Fpa      , Aa          , Rrc         , Aa^Fpa      , Aa^Fpa      , Aa^Fpa      , Aa^Fpa      
Ha          , Ha          , Mm          , Ha          , Ha          , Aa          , Rrc         , Rrc         , Ha          , Rrc         , Rrc         , Ha          , Rrc         , Aa^Fpa      , Rrc         , Ha          , Ha          , Mm          , Mm          , Mm          , Mm          , Ha          , Ha          , Rrc         , Ha          , Rrc         , Rrc         , Aa^Fpa      , Rrc         , Aa^Fpa      , Ha          , Mm          , Mm          , Ha          , Aa          , Aa          , Aa^Fpa      , Aa^Fpa      , Aa^Fpa      , Aa^Fpa      , Aa^Fpa      , Aa^Fpa      
Ha          , Ha          , Mm          , Mm          , Mm          , Ha          , Aa^Fpa      , Rrc         , Ha          , Mm          , Mm          , Rrc         , Rrc         , Aa          , Ha          , Ha          , Mm          , Mm          , Xu          , Xu          , Xu          , Mm          , Mm          , Ha          , Mm          , Ha          , Ha          , Rrc         , Ha          , Rrc         , Ha          , Mm          , Mm          , Ha          , Aa          , Aa          , Aa          , Aa^Fpa      , Aa^Fpa      , Aa^Fpa      , Aa^Fpa      , Aa^Fpa      
Mm          , Mm          , Mm          , Mm          , Mm          , Ha          , Aa^Fpa      , Aa^Vha      , Rrc         , Ha          , Mm          , Mm          , Mm          , Rrc         , Rrc         , Mm          , Cud         , Xu          , Iwr         , Iwr         , Iwr         , Xu          , Cud         , Mm          , Mm          , Mm          , Mm          , Ha          , Mm          , Ha          , Ha          , Ha          , Ha          , Ha          , Ha          , Gs          , Gs          , Aa          , Aa^Fpa      , Aa^Fpa      , Aa^Fpa      , Aa^Fpa      
Mm          , Mm          , Mm          , Mm          , Ha          , Ha          , Rrc         , Aa^Fpa      , Aa          , Ha          , Ha          , Mm          , Mm          , Mm          , Xu          , Cud         , Iwr         , Iwr         , Rr^Vhc      , Iwr         , Iwr         , Iwr         , Iwr         , Cud         , Xu          , Mm          , Mm          , Mm          , Mm          , Mm          , Ha          , Ha          , Aa          , Ha          , Mm          , Ha          , Ha          , Gs          , Gs          , Gs          , Aa          , Aa          
Mm          , Mm          , Mm          , Mm          , Mm          , Ha          , Rrc         , Aa^Fpa      , Aa          , Aa          , Ha          , Mm          , Mm          , Xu          , Iwr         , Iwr         , Iwr         , Iwr         , Iwr         , Iwr         , Iwr         , Rr^Vhc      , Iwr         , Iwr         , Iwr         , Xu          , Mm          , Mm          , Mm          , Ha^Vhha     , Ha          , Aa          , Aa          , Ha          , Mm          , Mm          , Ha          , Gs          , Gs          , Aa          , Aa          , Aa          
Mm          , Mm          , Ha          , Mm          , Mm          , Ha          , Rrc         , Ha          , Ha          , Aa          , Rrc         , Ha          , Mm          , Xu          , Iwr         , Iwr         , Rr^Vhc      , Iwr         , Iwr         , Iwr         , Iwr         , Iwr         , Iwr         , Iwr         , Iwr         , Xu          , Mm          , Mm          , Ha          , Ha          , Aa          , Aa          , Aa          , Ha          , Ha          , Mm          , Mm          , Ha          , Ha          , Ha          , Ha          , Ha          
Ha          , Ha          , Aa          , Ha          , Ha          , Ha          , Rrc         , Ha          , Rrc         , Aa          , Aa^Fpa      , Ha          , Ha          , Cud         , Iwr         , Iwr         , Iwr         , Iwr         , Cud         , Cud         , Cud         , Iwr         , Iwr         , Iwr         , Iwr         , Cud         , Re          , Ha          , Aa          , Aa          , Aa^Fpa      , Aa^Fpa      , Aa^Fpa      , Aa          , Ha          , Mm          , Mm          , Mm          , Mm          , Mm          , Mm          , Mm          
Aa          , Aa          , Aa          , Rrc         , Aa          , Aa          , Aa          , Rrc         , Aa^Vha      , Aa^Fpa      , Aa^Fpa      , Aa^Fpa      , Mm          , Cud         , Iwr         , Iwr         , Iwr         , Iwr         , Cud         , 2 Kud       , Cud         , Iwr         , Iwr         , Rr^Vhc      , Iwr         , Cud         , Mm          , Re          , Re          , Aa          , Aa^Fpa      , Aa^Fpa      , Aa^Fpa      , Aa          , Ha          , Mm          , Mm          , Mm          , Mm          , Mm          , Ha          , Ha          
Aa          , Aa          , Aa^Fpa      , Aa^Fpa      , Aa^Fpa      , Aa          , Ha          , Ha          , Aa          , Aa          , Ha          , Mm          , Mm          , Xu          , Iwr         , Iwr         , Rr^Vhc      , Iwr         , Iwr         , Cud         , Iwr         , Iwr         , Iwr         , Iwr         , Iwr         , Xu          , Mm          , Aa^Fpa      , Aa          , Re          , Re          , Aa^Fpa      , Aa          , Ha          , Mm          , Mm          , Mm          , Mm          , Mm          , Mm          , Cha         , Aa          
Rrc         , Rrc         , Aa^Fpa      , Aa^Fpa      , Aa^Fpa      , Aa          , Ha          , Ha          , Rrc         , Aa          , Ha          , Mm          , Mm          , Xu          , Iwr         , Iwr         , Iwr         , Iwr         , Ww          , Iwr         , Ww          , Ww          , Ww          , Ww          , Iwr         , Xu          , Mm          , Ha          , Ha          , Aa          , Re          , Aa^Fpa      , Aa          , Ha          , Mm          , Mm          , Mm          , Mm          , Cha         , Cha         , 6 Kha       , Cha         
Rrc         , Rrc         , Rrc         , Aa^Fpa      , Aa^Fpa      , Aa^Fpa      , Rrc         , Rrc         , Ha          , Ha          , Mm          , Mm          , Mm          , Xu          , Xu          , Iwr         , Iwr         , Iwr         , Iwr         , Ww          , Ww          , Ai          , Ai          , Ww          , Xu          , Xu          , Mm          , Mm          , Mm          , Ha          , Re          , Aa          , Aa          , Ha          , Ha          , Ha          , Mm          , Mm          , Cha         , Kha         , Kha         , Cha         
Ha          , Rrc         , Ha          , Rrc         , Aa^Fpa      , Aa^Fpa      , Aa^Fpa      , Rrc         , Ha          , Ha          , Mm          , Mm          , Mm          , Mm          , Mm          , Xu          , Cud         , Iwr         , Iwr         , Iwr         , Ww          , Ai          , Ai          , Xu          , Mm          , Mm          , Mm          , Mm          , Mm          , Ha          , Ha          , Re          , Aa          , Aa          , Aa          , Ha          , Aa^Fpa      , Mm          , Cha         , Cha         , Cha         , Cha         
Mm          , Mm          , Ha          , Rrc         , Rrc         , Aa^Fpa      , Rrc         , Aa^Fpa      , Ha          , Mm          , Mm          , Mm          , Ha          , Mm          , Ha          , Mm          , Re          , Cud         , Xu          , Rr^Vhc      , Xu          , Ai          , Ai          , Mm          , Mm          , Mm          , Mm          , Mm          , Mm          , Mm          , Ha          , Re          , Aa          , Aa          , Aa          , Aa^Fpa      , Aa^Fpa      , Ha          , Aa^Fpa      , Cha         , Aa^Fpa      , Aa^Fpa      
Mm          , Mm          , Mm          , Ha          , Aa^Fpa      , Rrc         , Ha          , Rrc         , Ha          , Ha          , Ha          , Ha          , Ha          , Ha          , Ha          , Re          , Ha          , Mm          , Mm          , Xu          , Mm          , Mm          , Ww          , Ww          , Ha          , Ha          , Ha          , Ha          , Ha          , Mm          , Re          , Re          , Ha          , Aa          , Ha          , Aa^Fpa      , Ha          , Ha          , Ha^Vhha     , Aa^Fpa      , Aa^Fpa      , Aa^Fpa      
Mm          , Mm          , Mm          , Mm          , Ha          , Ha          , Ha          , Aa^Vha      , Re          , Re          , Re          , Re          , Re          , Re          , Re          , Re          , Aa          , Ha          , Mm          , Ms^Xm       , Mm          , Mm          , Ww          , Ww          , Aa          , Aa          , Aa          , Aa          , Aa          , Re          , Aa          , Aa          , Ha          , Ha          , Mm          , Ha          , Mm          , Mm          , Ha          , Aa^Fpa      , Ha          , Ha          
Mm          , Mm          , Mm          , Mm          , Ha          , Gs          , Ha          , Re          , Ha          , Mm          , Mm          , Ha          , Gs          , Ha          , Ha          , Aa          , Ms^Xm       , Mm          , Ms^Xm       , Ms^Xm       , Ha          , Ha          , Ww          , Ww          , Aa          , Aa          , Ha          , Gd^Vhr      , Re          , Re          , Aa          , Aa          , Aa          , Ha          , Mm          , Mm          , Mm          , Mm          , Ha          , Ha          , Mm          , Mm          
Mm          , Mm          , Mm          , Mm          , Ha          , Gs          , Gs          , Re          , Ha          , Mm          , Mm          , Ha          , Ha          , Ha          , Mm          , Ms^Xm       , Mm          , Mm          , Ha          , Mm          , Ha          , Ha          , Ww          , Ww          , Aa          , Ha          , Ha          , Re          , Aa^Fpa      , Aa^Fpa      , Aa^Fpa      , Aa          , Ha          , Ha          , Ha          , Mm          , Mm          , Mm          , Mm          , Mm          , Ha          , Ha          
Ha          , Ha          , Ha          , Ha          , Ha          , Gs          , Re          , Re          , Ha          , Ha          , Mm          , Mm          , Mm          , Mm          , Mm          , Mm          , Aa          , Mm          , Ha          , Ha          , Ww          , Ww          , Ww          , Aa^Fpa      , Aa          , Ha          , Aa          , Re          , Aa^Fpa      , Aa^Fpa      , Aa^Fpa      , Aa          , Ha          , Ha          , Mm          , Mm          , Mm          , Mm          , Mm          , Mm          , Ha          , Ha          
Gs          , Gs          , Gs          , Gs          , Gs          , Gs          , Re          , Gs          , Ha          , Mm          , Mm          , Mm          , Ms^Xm       , Ms^Xm       , Ha          , Ha          , Aa          , Aa          , Aa          , Aa          , Ww          , Ww          , Aa^Fpa      , Aa^Fpa      , Aa          , Aa          , Aa          , Re          , Gs          , Aa^Fpa      , Aa^Fpa      , Aa^Fpa      , Ha          , Mm          , Mm          , Mm          , Mm          , Mm          , Mm          , Mm          , Ha          , Ha^Fpa      
Gs          , Gs          , Aa^Fpa      , Gs          , Re          , Re          , Ha          , Gs          , Ha          , Mm          , Mm          , Ms^Xm       , Ms^Xm       , Mm          , Ha          , Ha          , Aa          , Aa          , Aa          , Aa          , Ww          , Ww          , Ww          , Aa^Fpa      , Aa^Fpa      , Aa^Fpa      , Aa          , Re          , Re          , Gs          , Aa          , Aa          , Ha          , Mm          , Ha          , Mm          , Mm          , Mm          , Mm          , Ha          , Ha^Fpa      , Ha^Fpa      
Aa^Fpa      , Aa^Fpa      , Aa^Fpa      , Re          , Ha          , Ha          , Mm          , Ha          , Ha^Vhha     , Ha          , Mm          , Ms^Xm       , Mm          , Mm          , Ha          , Ha          , Ha          , Ha          , Gs          , Gs          , Aa^Fpa      , Ww          , Ww          , Aa^Fpa      , Aa          , Aa          , Aa          , Gs          , Gs          , Re          , Aa          , Gs          , Aa^Fpa      , Ha^Vhha     , Gs          , Ha          , Ha          , Mm          , Mm          , Mm          , Ha          , Ha^Fpa      
Aa^Fpa      , Aa^Fpa      , Aa^Fpa      , Re          , Ha          , Ha          , Mm          , Mm          , Mm          , Mm          , Ms^Xm       , Ms^Xm       , Ms^Xm       , Mm          , Mm          , Ha^Vhha     , Mm          , Ha          , Gs          , Gs          , Ai          , Ai          , Ww          , Ai          , Ai          , Aa          , Aa          , Aa          , Gs          , Aa          , Aa          , Gs          , Aa^Fpa      , Aa^Fpa      , Gs          , Gs          , Ha          , Mm          , Ha          , Ha          , Aa          , Aa          
Aa^Fpa      , Aa^Fpa      , Cea         , Cea         , Cea         , Ha          , Mm          , Mm          , Mm          , Mm          , Ms^Xm       , Ms^Xm       , Mm          , Mm          , Mm          , Mm          , Ha          , Ha          , Aa          , Gs          , Ai          , Ai          , Ai          , Ww          , Ai          , Aa          , Aa          , Aa          , Gs          , Aa          , Re          , Gs          , Ce          , Gs          , Aa          , Gs          , Gs          , Ha          , Aa          , Aa          , Aa^Fpa      , Aa^Fpa      
Re          , Re          , Cea         , 4 Ke        , Cea         , Ha^Vhha     , Ha          , Mm          , Mm          , Ms^Xm       , Ms^Xm       , Ms^Xm       , Mm          , Mm          , Mm          , Ha          , Aa          , Aa          , Aa^Fpa      , Gs          , Gs          , Ai          , Ai          , Ww          , Ha          , Ha          , Mm          , Aa          , Gs          , Gs          , Ce          , Ce          , Ke          , Ce          , Ce          , Aa          , Aa          , Aa          , Aa^Fpa      , Aa^Fpa      , Aa^Fpa      , Aa^Fpa      
Gs          , Gs          , Gs          , Cea         , Ha          , Ha          , Ha          , Ha          , Mm          , Ms^Xm       , Ms^Xm       , Mm          , Mm          , Ms^Xm       , Mm          , Ha          , Ha^Fpa      , Aa          , Aa^Fpa      , Aa^Fpa      , Gs          , Aa          , Aa          , Ww          , Ww          , Mm          , Mm          , Ha          , Gs^Vh       , Ce          , Ke          , 5 Ke        , Ke          , Ke          , Ce          , Aa          , Aa          , Aa          , Aa          , Aa^Fpa      , Aa^Fpa      , Aa^Fpa      
Gs          , Gs          , Gs          , Ha          , Ha          , Ha          , Mm          , Ms^Xm       , Mm          , Ms^Xm       , Ms^Xm       , Mm          , Ms^Xm       , Ms^Xm       , Ha          , Ha          , Ha^Fpa      , Ha          , Ha          , Aa^Fpa      , Gs          , Aa          , Ww          , Ww          , Ww          , Mm          , Mm          , Ha          , Gs          , Ce          , Ce          , Ke          , Ce          , Ce          , Gs          , Aa          , Aa          , Aa          , Aa^Fpa      , Aa          , Aa          , Gs          
Aa^Fpa      , Aa^Fpa      , Gs          , Ha          , Ha          , Mm          , Mm          , Ms^Xm       , Mm          , Mm          , Ha          , Mm          , Ms^Xm       , Ms^Xm       , Mm          , Ha          , Ha          , Ha          , Aa^Fpa      , Ha^Fpa      , Gs          , Ww          , Ww          , Ww          , Ha          , Mm          , Ha          , Gs          , Aa^Fpa      , Aa^Fpa      , Gs          , Ce          , Gs          , Gs          , Aa          , Aa          , Aa          , Gs          , Aa^Fpa      , Gs          , Gs^Vh       , Gs          
Aa^Fpa      , Aa^Fpa      , Gs          , Gs          , Ha          , Mm          , Mm          , Ms^Xm       , Ha          , Mm          , Ha          , Ha          , Ms^Xm       , Mm          , Mm          , Mm          , Ha          , Aa          , Aa^Fpa      , Ha          , Gs          , Ww          , Aa          , Aa          , Aa          , Ha          , Gs          , Gs          , Gs          , Aa^Fpa      , Re          , Re          , Aa          , Aa          , Aa          , Aa          , Aa^Fpa      , Gs          , Aa          , Aa          , Gs          , Gs          
Aa^Fpa      , Aa^Fpa      , Aa^Fpa      , Ha^Fpa      , Mm          , Mm          , Mm          , Ms^Xm       , Ha^Vhha     , Ha          , Ms^Xm       , Ms^Xm       , Ha          , Mm          , Mm          , Mm          , Mm          , Ha          , Gs          , Gs          , Ww          , Ww          , Ai          , Ai          , Aa          , Aa          , Aa          , Aa          , Aa          , Gs          , Re          , Gs          , Aa          , Aa          , Gs          , Gs          , Aa^Fpa      , Aa^Fpa      , Aa          , Aa          , Aa          , Aa          
Aa^Fpa      , Aa^Fpa      , Ha^Fpa      , Ha^Fpa      , Mm          , Mm          , Mm          , Ms^Xm       , Ha          , Ms^Xm       , Ms^Xm       , Ms^Xm       , Ha          , Mm          , Mm          , Mm          , Mm          , Ha          , Gs          , Gs          , Ww          , Ww          , Ai          , Ai          , Gs          , Aa          , Aa          , Aa          , Aa          , Gs          , Re          , Gs          , Gs          , Gs          , Gs          , Gs          , Aa^Fpa      , Aa^Fpa      , Aa          , Aa          , Aa          , Aa          
