border_size=1
usage=map

Aa          , Aa          , Rr          , Aa^Fpa      , Aa^Fpa      , Aa^Fpa      , Aa^Fpa      , Aa^Fpa      , Aa^Fpa      , Aa^Fpa      , Aa^Fpa      , Aa^Fpa      , Aa^Fpa      , Aa^Fpa      , Aa^Fpa      , Aa^Fpa      , Aa^Fpa      , Aa^Fpa      , Aa^Fpa      , Ai          , Ai          , Ai          , Ai          , Aa^Fpa      , Aa^Fpa      , Aa^Fpa      , Aa^Fpa      , Aa^Fpa      , Aa^Fpa      , Aa^Fpa      , Hh          , Ms          , Ms          , Hh          , Ms          , Hh          , Ms          , Aa^Fpa      , Aa^Fpa      , Aa^Fpa      , Aa^Fpa      , Aa^Fpa      
Aa          , Aa          , Rr          , Aa^Fpa      , Rr          , Aa^Fpa      , Aa^Fpa      , Aa^Fpa      , Khr         , Khr         , Aa^Fpa      , Aa^Fpa      , Aa^Fpa      , Aa^Fpa      , Aa^Fpa      , Aa^Fpa      , Aa^Fpa      , Aa^Fpa      , Ai          , Ai          , Ai          , Ai          , Ai          , Aa^Fpa      , Aa^Fpa      , Aa^Fpa      , Aa^Fpa      , Aa^Fpa      , Aa^Fpa      , Aa^Fpa      , Hh          , Ms          , Ms          , Hh          , Ms          , Hh          , Ms          , Aa^Fpa      , Aa^Fpa      , Aa^Fpa      , Aa^Fpa      , Aa^Fpa      
Aa^Fma      , Aa^Fma      , Aa^Fma      , Rr          , Aa^Fma      , Rr          , Aa^Fpa      , Khr         , Aa^Fma      , Aa^Fma      , Aa^Fma      , Aa^Fpa      , Aa^Fpa      , Aa^Fpa      , Aa^Fpa      , Aa^Fpa      , Ai          , Ai          , Ai          , Ai          , Aa^Fpa      , Ai          , Aa^Fpa      , Aa^Fpa      , Aa^Fpa      , Aa^Fpa      , Ms          , Ms          , Hh          , Aa^Fpa      , Aa^Fpa      , Ms          , Hh          , Aa^Fma      , Aa^Fma      , Ms          , Ms          , Ms          , Ha^Fma      , Aa^Fpa      , Aa^Fpa      , Aa^Fpa      
Aa^Fma      , Aa^Fma      , Chr         , 3 Khr       , Chr         , Rr          , Rr          , Aa^Fma      , Aa^Vha      , Aa          , Aa          , Aa^Vha      , Aa          , Aa^Fpa      , Ai          , Ai          , Ai          , Ai          , Ai          , Aa^Fpa      , Aa^Fpa      , Aa^Fpa      , Ms          , Aa^Fpa      , Ms          , Hh          , Ms          , Ms          , Ms          , Ms          , Ms          , Aa^Fpa      , Aa^Fpa      , Ms          , Gs^Fp       , Ms          , Ha^Fma      , Ms          , Ha^Fma      , Aa^Fpa      , Aa^Fpa      , Aa^Fpa      
Aa          , Aa^Vha      , Chr         , Chr         , Chr         , Aa^Fma      , Aa          , Aa          , Rr          , Aa          , Ai          , Aa          , Ai          , Ai          , Ai          , Ai          , Ai          , Ai          , Ai          , Aa^Fpa      , Aa^Fpa      , Aa^Fpa      , Aa^Fpa      , Ms          , Aa^Fpa      , Ms          , Aa^Fpa      , Ms          , Aa^Fpa      , Aa^Fpa      , Aa^Fpa      , Aa^Fpa      , Aa^Fpa      , Aa^Fpa      , Aa^Fpa      , Ms          , Ha^Fma      , Ms          , Ha^Fma      , Aa^Fpa      , Aa^Fpa      , Aa^Fpa      
Aa          , Aa          , Aa^Fma      , Khr         , Khr         , Aa          , Aa^Vha      , Aa          , Aa          , Rr          , Ai          , Ai          , Ai          , Ai          , Ai          , Ai          , Aa^Fpa      , Ai          , Ai          , Ai          , Aa^Fpa      , Aa^Fpa      , Aa^Fpa      , Hh          , Ms          , Aa^Fpa      , Aa^Fpa      , Aa^Fpa      , Aa^Fpa      , Aa^Fpa      , Aa^Fpa      , Aa^Fpa      , Aa          , Aa^Fpa      , Aa^Fpa      , Aa^Fpa      , Ms          , Ha^Fma      , Aa^Fpa      , Aa^Fpa      , Aa^Fpa      , Aa^Fpa      
Aa          , Aa          , Aa^Fma      , Aa^Fma      , Aa^Fma      , Khr         , Aa          , Aa          , Ai          , Ai          , Ai          , Ai          , Ai          , Ai          , Aa^Fpa      , Aa^Fpa      , Ai          , Ai          , Ai          , Ai          , Aa          , Aa^Fpa      , Aa          , Aa^Fpa      , Ha^Fda      , Ha^Fda      , Aa^Fpa      , Aa^Fpa      , Aa^Fma      , Aa^Fma      , Aa^Fma      , Aa^Fma      , Aa^Fma      , Aa^Fma      , Ms          , Aa^Fpa      , Ha^Fma      , Ms          , Ha^Fma      , Aa^Fpa      , Aa^Fpa      , Aa^Fpa      
Aa^Fma      , Aa^Fma      , Aa^Fma      , Aa^Fma      , Aa^Fma      , Aa^Fma      , Aa^Vha      , Ai          , Ai          , Ai          , Ai          , Ai          , Ai          , Ai          , Ai          , Ai          , Ai          , Ai          , Ai          , Ai          , Aa          , Aa^Fpa      , Aa^Fpa      , Aa^Fpa      , Ha^Fda      , Ms          , Ms          , Aa^Fpa      , Aa^Fma      , Aa^Fma      , Ha^Fma      , Ha^Fma      , Aa^Vha      , Ai          , Ha^Fma      , Ms          , Gs^Fp       , Ha^Fma      , Ha^Fma      , Aa^Fpa      , Aa^Fpa      , Aa^Fpa      
Aa^Fma      , Aa^Fma      , Aa^Fma      , Aa^Fma      , Aa^Fma      , Aa^Fma      , Aa^Fma      , Ai          , Ai          , Ai          , Ai          , Ai          , Ai          , Ai          , Ai          , Ai          , Ai          , Ai          , Ai          , Ai          , Aa          , Aa          , Aa          , Ha^Fda      , Ms          , Ms          , Ms          , Ms          , Ms          , Aa^Fma      , Aa          , Aa^Vha      , Aa^Vea      , Aa^Vha      , Ha^Fma      , Ms          , Ha^Fma      , Ha^Fma      , Aa^Fpa      , Aa^Fpa      , Aa^Fpa      , Aa^Fpa      
Aa^Fma      , Aa^Fma      , Aa^Fma      , Aa^Fma      , Aa^Fma      , Aa^Fma      , Ai          , Ai          , Ai          , Ai          , Ai          , Ai          , Ai          , Ai          , Ai          , Ai          , Ai          , Ai          , Ai          , Ai          , Ai          , Aa          , Aa          , Aa^Fpa      , Aa^Fpa      , Ha^Fma      , Ha^Fma      , Aa          , Ms          , Ms          , Ms          , Aa^Vha      , Aa^Vha      , Aa^Vha      , Ms          , Ms          , Aa^Fpa      , Ms          , Aa^Fpa      , Aa^Fpa      , Aa          , Aa          
Aa^Fma      , Aa^Fma      , Aa^Fma      , Aa^Fma      , Ai          , Ai          , Ai          , Ai          , Ai          , Ai          , Ai          , Ai          , Ai          , Ai          , Ai          , Ai          , Ai          , Ai          , Aa          , Aa^Fma      , Aa^Fma      , Ai          , Aa          , Aa^Fpa      , Aa^Fpa      , Aa          , Aa^Vha      , Aa          , Ms          , Ms          , Hh          , Aa          , Aa^Fpa      , Ms          , Aa^Fpa      , Ms          , Ms          , Aa^Fpa      , Aa^Vha      , Aa^Fpa      , Aa          , Aa          
Aa^Fma      , Aa^Fma      , Ai          , Ai          , Aa^Fda      , Aa^Fda      , Aa^Fda      , Ai          , Ai          , Ai          , Ai          , Ai          , Ai          , Ai          , Ai          , Ai          , Aa^Fma      , Aa          , Aa^Fma      , Aa^Fma      , Aa^Fma      , Ai          , Ai          , Aa          , Aa^Fpa      , Aa          , Aa          , Aa^Fpa      , Aa^Fpa      , Ms          , Ms          , Aa^Fpa      , Aa          , Aa^Fpa      , Ms          , Ms          , Aa          , Aa          , Aa^Fpa      , Aa          , Aa^Fpa      , Aa^Fpa      
Ai          , Ai          , Ai          , Aa^Fda      , Aa          , Aa^Vha      , Aa^Fda      , Ai          , Ai          , Ai          , Aa^Fma      , Ai          , Aa^Fpa      , Ai          , Ha          , Ha          , Ha          , Aa          , Ha          , Ha          , Ha          , Aa          , Aa          , Ai          , Aa^Fpa      , Aa^Fpa      , Aa^Fpa      , Aa^Fpa      , Aa^Fpa      , Aa^Fpa      , Aa^Fpa      , Aa^Fpa      , Aa^Fpa      , Aa          , Aa          , Aa          , Ha          , Ha          , Aa^Fpa      , Aa^Fpa      , Aa^Fpa      , Aa^Fpa      
Aa^Fda      , Aa^Fda      , Aa^Fda      , Aa^Fda      , Aa^Fda      , Aa          , Aa^Fda      , Aa^Fda      , Aa          , Aa^Fma      , Aa^Fma      , Aa^Fpa      , Aa^Fpa      , Aa^Fpa      , Aa^Fpa      , Ha          , Ha          , Aa          , Aa          , Ha          , Aa^Fma      , Aa^Fma      , Ai          , Ai          , Aa^Fpa      , Aa^Fpa      , Aa          , Aa^Fpa      , Aa^Fpa      , Aa^Fpa      , Aa^Fpa      , Aa^Fpa      , Aa          , Aa          , Aa^Fpa      , Ha          , Aa^Fpa      , Aa^Fpa      , Aa^Fpa      , Aa^Fpa      , Aa^Fpa      , Aa^Fpa      
Aa^Fda      , Aa^Fda      , Aa          , Aa^Fda      , Aa^Fda      , Aa^Fda      , Aa          , Aa^Fda      , Aa          , Aa          , Aa          , Aa^Fpa      , Aa^Fpa      , Aa^Fpa      , Aa^Fpa      , Aa^Fpa      , Aa^Fpa      , Ha          , Aa          , Aa^Fma      , Aa^Fma      , Aa^Fma      , Aa^Fma      , Ai          , Aa          , Aa          , Aa^Fpa      , Aa          , Aa^Fpa      , Aa          , Aa^Fpa      , Aa          , Aa^Fpa      , Aa^Fpa      , Aa^Fpa      , Aa^Fpa      , Aa^Fpa      , Aa^Fpa      , Aa^Fpa      , Aa^Fpa      , Aa^Fpa      , Aa^Fpa      
Aa          , Aa          , Aa^Fda      , Aa          , Aa          , Aa          , Aa          , Aa^Fma      , Aa^Fma      , Aa^Fma      , Aa^Fma      , Aa          , Aa          , Aa^Fpa      , Aa^Fpa      , Aa^Fpa      , Aa^Fpa      , Aa^Fpa      , Aa          , Aa^Fma      , Aa^Fma      , Aa^Fma      , Aa          , Ai          , Ai          , Aa^Fpa      , Ha          , Aa^Fpa      , Aa^Fpa      , Aa          , Aa          , Aa^Fpa      , Aa^Fpa      , Aa^Fpa      , Aa^Fpa      , Aa^Fpa      , Aa          , Aa          , Aa          , Aa^Vha      , Aa^Fpa      , Aa^Fpa      
Aa^Fda      , Aa^Fda      , Aa^Vha      , Aa^Fda      , Aa^Fda      , Aa          , Aa^Fda      , Aa^Fda      , Aa^Fma      , Aa^Fma      , Aa^Fma      , Aa^Fma      , Aa          , Aa^Fpa      , Aa^Fpa      , Aa^Fpa      , Aa^Fpa      , Aa^Fpa      , Aa^Fpa      , Aa          , Aa          , Aa          , Aa^Fpa      , Ai          , Ai          , Ha          , Ha          , Aa^Fpa      , Aa^Vha      , Aa^Fpa      , Aa^Fpa      , Aa          , Aa          , Aa^Fpa      , Aa^Fpa      , Aa^Fpa      , Aa          , Aa          , Aa          , Aa          , Aa^Fpa      , Aa^Fpa      
Aa^Fda      , Aa^Fda      , Aa^Fda      , Aa^Fda      , Aa^Fda      , Aa^Fda      , Aa          , Aa          , Aa          , Aa^Fma      , Aa^Fma      , Aa          , Aa^Fpa      , Aa^Fpa      , Aa^Fpa      , Aa^Fpa      , Aa^Fpa      , Aa^Fpa      , Aa^Fpa      , Aa^Fpa      , Aa^Fpa      , Aa          , Aa^Fpa      , Aa^Fpa      , Aa^Fpa      , Ai          , Aa^Fpa      , Gg          , Aa^Fpa      , Aa^Fpa      , Aa          , Aa          , Aa          , Aa^Fpa      , Aa          , Aa^Fpa      , Aa          , Aa          , Aa^Fpa      , Aa^Fpa      , Aa^Fpa      , Aa^Fpa      
Aa^Fda      , Aa^Fda      , Aa          , Aa          , Aa^Fda      , Aa          , Aa^Fma      , Aa^Fma      , Aa^Fma      , Aa          , Aa          , Aa          , Aa^Fpa      , Aa^Fpa      , Aa^Fpa      , Aa^Fpa      , Aa^Fpa      , Aa^Fpa      , Aa^Fpa      , Ha          , Ha          , Aa^Fpa      , Ha^Fma      , Ha^Fma      , Aa^Fpa      , Ai          , Aa^Fpa      , Aa^Fpa      , Aa^Fpa      , Aa^Fpa      , Aa          , Aa          , Aa          , Aa^Fpa      , Aa^Fpa      , Aa          , Aa          , Aa^Fpa      , Aa^Fpa      , Aa^Fpa      , Aa          , Aa          
Aa^Fda      , Aa^Fda      , Aa          , Aa^Fma      , Aa^Fma      , Aa          , Aa          , Aa^Fma      , Aa          , Aa^Fma      , Aa^Fma      , Aa          , Aa          , Aa^Fpa      , Aa^Fpa      , Aa^Fpa      , Aa          , Aa^Fpa      , Aa^Fpa      , Aa^Vha      , Aa^Vha      , Ha^Fma      , Ha^Fma      , Aa^Fpa      , Aa^Fpa      , Ai          , Aa^Fpa      , Aa^Fpa      , Aa^Fpa      , Aa^Fpa      , Aa^Fpa      , Aa          , Aa          , Aa^Fpa      , Aa^Fpa      , Aa^Fpa      , Aa^Fpa      , Aa          , Aa          , Aa          , Aa^Fpa      , Aa^Fpa      
Aa          , Aa          , Aa^Fma      , Aa^Fma      , Ms          , Aa^Fma      , Aa          , Aa^Fma      , Aa^Fma      , Aa^Fma      , Ai          , Aa^Fma      , Aa^Fma      , Aa          , Aa          , Aa          , Aa^Fpa      , Aa^Fpa      , Aa^Fpa      , Aa^Fpa      , Aa^Fpa      , Aa^Fpa      , Aa^Fpa      , Aa^Fpa      , Ai          , Ai          , Aa^Fpa      , Aa^Fpa      , Hh          , Aa^Fpa      , Aa^Fpa      , Aa          , Aa          , Aa^Fpa      , Aa^Fpa      , Hh          , Aa^Fpa      , Aa^Fpa      , Aa^Fpa      , Aa^Fpa      , Aa^Fpa      , Aa^Fpa      
Aa^Fma      , Aa^Fma      , Aa^Fma      , Aa^Fma      , Ms          , Ms          , Aa^Fma      , Aa^Fma      , Aa          , Mm          , Ai          , Ai          , Aa^Fma      , Aa^Fma      , Aa          , Aa^Fpa      , Aa^Fpa      , Aa^Fpa      , Aa^Fpa      , Aa^Fpa      , Aa^Fpa      , Aa^Fpa      , Ai          , Ai          , Aa          , Aa^Fpa      , Aa^Fpa      , Aa^Fpa      , Aa^Vha      , Hh          , Aa^Fpa      , Aa          , Aa          , Aa          , Aa          , Ce          , Aa^Fpa      , Aa^Fpa      , Ce          , Hh          , Aa^Fpa      , Aa^Fpa      
Aa^Fma      , Aa^Fma      , Aa^Fma      , Ms          , Hh          , Aa          , Aa          , Aa          , Ce          , Ai          , Aa          , Hh          , Ms          , Aa^Fma      , Aa^Fma      , Aa          , Aa^Fpa      , Aa^Fpa      , Aa^Fpa      , Aa^Fpa      , Aa^Fpa      , Aa^Fpa      , Ai          , Aa^Fpa      , Aa          , Aa^Vha      , Aa          , Aa          , Aa          , Aa          , Aa          , Ce          , Aa          , Aa          , Aa          , Aa          , Aa^Fpa      , Aa^Fpa      , Aa^Fpa      , Hh          , Aa^Fpa      , Aa^Fpa      
Aa^Fma      , Aa^Fma      , Aa          , Aa          , Ai          , Ai          , Aa          , Ce          , 4 Ke        , Ce          , Aa          , Ms          , Ms          , Ha^Fda      , Ha^Fda      , Ha^Fda      , Aa          , Aa^Fpa      , Aa^Fpa      , Ai          , Aa^Fpa      , Aa^Fpa      , Ai          , Aa^Fpa      , Aa^Vha      , Aa          , Aa          , Aa          , Hh          , Aa^Fpa      , Aa          , Aa          , Aa^Fpa      , Aa^Fpa      , Ce          , Ce          , Ce          , Aa^Fpa      , Aa^Fpa      , Aa^Fpa      , Aa^Fpa      , Aa^Fpa      
Aa^Fma      , Aa^Fma      , Aa          , Aa          , Ai          , Aa          , Aa          , Ce          , Ce          , Ce          , Aa          , Ha^Fda      , Ms          , Ha^Fda      , Ha^Fda      , Ha^Fda      , Aa          , Aa^Fda      , Aa^Fpa      , Aa^Fda      , Aa^Fda      , Aa^Fda      , Ai          , Aa^Fpa      , Aa^Fpa      , Aa^Fpa      , Aa^Fpa      , Hh          , Aa^Fpa      , Aa^Fpa      , Aa^Fpa      , Aa^Fpa      , Aa^Fpa      , Aa^Fpa      , Ce          , 2 Ke        , Ce          , Aa          , Aa          , Aa^Fpa      , Aa^Fpa      , Aa^Fpa      
Aa^Fma      , Aa^Fma      , Aa^Fpa      , Aa          , Aa          , Aa          , Aa^Fma      , Aa          , Aa          , Ai          , Ai          , Ai          , Ms          , Ms          , Ha^Fda      , Ha^Fda      , Aa          , Aa^Fda      , Aa^Fda      , Aa^Fda      , Aa^Fda      , Aa^Fda      , Aa^Fda      , Ai          , Ai          , Aa          , Aa          , Aa^Fpa      , Aa^Fpa      , Aa          , Aa^Fpa      , Aa^Fpa      , Aa          , Aa^Fpa      , Aa^Fpa      , Ce          , Aa^Fpa      , Aa^Fpa      , Aa          , Aa^Fpa      , Aa^Fpa      , Aa^Fpa      
Aa^Fma      , Aa^Fpa      , Aa^Fpa      , Aa^Fpa      , Aa^Fma      , Aa          , Aa          , Aa^Fma      , Aa          , Aa          , Ms          , Ms          , Ms          , Ha^Fda      , Aa          , Aa^Fma      , Aa^Fma      , Aa          , Aa          , Aa          , Aa          , Aa^Fda      , Aa^Fda      , Aa          , Aa          , Ai          , Aa          , Aa^Fpa      , Aa^Fpa      , Aa          , Aa          , Aa          , Aa          , Aa          , Aa^Fpa      , Aa^Fpa      , Ms          , Aa^Fpa      , Aa^Fpa      , Aa          , Aa          , Aa          
Aa^Fma      , Aa^Fpa      , Aa^Fpa      , Aa^Fpa      , Aa^Fpa      , Aa^Fma      , Aa          , Ha^Fma      , Aa          , Aa          , Ms          , Ms          , Aa^Fpa      , Ha^Fda      , Aa          , Ha          , Aa^Fma      , Aa^Fma      , Aa^Fma      , Aa^Fma      , Aa^Fma      , Aa^Fma      , Aa          , Aa^Fda      , Aa^Fda      , Ai          , Aa          , Aa^Fpa      , Aa          , Aa          , Aa          , Ce          , Aa^Fpa      , Aa^Fpa      , Ms          , Ms          , Aa          , Aa^Fpa      , Aa          , Aa^Fpa      , Aa^Fpa      , Aa^Fpa      
Aa^Fma      , Aa^Fma      , Aa          , Aa^Fpa      , Aa          , Aa          , Aa^Vha      , Ha^Fma      , Ha^Fma      , Ha^Fma      , Aa^Fma      , Aa^Fma      , Aa^Fma      , Aa          , Ha          , Aa^Fma      , Aa^Fma      , Ha          , Ms          , Ha          , Ms          , Aa^Fma      , Aa          , Aa          , Aa^Fma      , Ai          , Aa          , Aa^Fpa      , Aa          , Aa          , Aa^Fpa      , Aa^Fpa      , Ms          , Ms          , Aa          , Ms          , Aa          , Aa          , Aa          , Ms          , Aa^Fpa      , Aa^Fpa      
Aa          , Aa          , Aa          , Aa^Fpa      , Aa          , Aa          , Aa          , Aa          , Aa^Fpa      , Ha^Fpa      , Aa^Fma      , Aa^Fma      , Aa          , Aa^Vha      , Aa^Fma      , Ha          , Ms          , Ms          , Ms          , Ms          , Ms          , Ms          , Ha          , Aa^Fma      , Aa^Fma      , Ai          , Ai          , Aa^Fpa      , Aa^Fpa      , Aa^Fpa      , Aa^Fma      , Ms          , Ms          , Aa          , Aa          , Aa          , Aa^Vha      , Aa^Fma      , Ms          , Ms          , Aa^Fpa      , Aa^Fpa      
Ha^Fma      , Ha^Fma      , Ha^Fma      , Aa          , Ha^Fma      , Aa          , Aa^Fpa      , Aa^Fpa      , Aa^Fpa      , Aa^Fda      , Aa          , Aa^Fma      , Ha          , Aa^Fma      , Ms          , Ms          , Ms          , Ms          , Ms          , Ms          , Ms          , Ms          , Ms          , Ha          , Aa^Fma      , Aa^Vha      , Ai          , Aa^Fpa      , Ai          , Aa^Fma      , Aa^Fda      , Ha          , Ms          , Ms          , Ms          , Aa^Fma      , Aa^Fma      , Ce          , Ai          , Ms          , Ms          , Ms          
Aa^Fpa      , Ha^Fma      , Aa^Fpa      , Ha^Fma      , Aa          , Aa          , Aa^Fpa      , Aa^Fpa      , Aa          , Aa          , Ha          , Aa^Fma      , Aa^Fma      , Aa^Fma      , Aa^Fma      , Ha          , Ms          , Ms          , Ms          , Ms          , Ms          , Ms          , Ms          , Ms          , Aa^Fma      , Aa          , Ai          , Ai          , Ai          , Ai          , Ai          , Aa^Fda      , Ms          , Aa^Fda      , Ms          , Aa          , Aa          , Aa          , Ai          , Ms          , Ms          , Ms          
Aa^Fpa      , Aa^Fpa      , Aa^Fpa      , Aa          , Aa^Fpa      , Aa          , Aa^Fpa      , Aa          , Aa^Fda      , Aa          , Ha          , Aa^Fma      , Aa^Fma      , Aa^Fma      , Aa^Fma      , Ms          , Ha          , Ms          , Ms          , Ms          , Ms          , Ha          , Ha          , Ha          , Aa^Fma      , Aa          , Ai          , Aa^Fda      , Ai          , Ms          , Ha          , Ha          , Ms          , Ms          , Ms          , Ms          , Ha^Fda      , Ha^Fda      , Ha^Fda      , Ms          , Ha^Fda      , Ha^Fda      
Aa^Fpa      , Aa^Fpa      , Aa^Fpa      , Aa^Fpa      , Aa^Fpa      , Aa^Fpa      , Aa          , Aa          , Ha          , Aa          , Aa          , Aa^Fma      , Aa^Vha      , Aa^Fma      , Ha          , Aa          , Aa          , Aa          , Ms          , Ms          , Ms          , Ms          , Aa^Fma      , Aa^Fma      , Aa^Fma      , Aa          , Ai          , Aa^Fda      , Ha^Fda      , Ms          , Ms          , Ha^Fda      , Ms          , Ms          , Aa          , Ms          , Aa          , Aa          , Aa          , Ha^Fda      , Aa          , Ha^Fda      
Aa          , Aa          , Aa          , Aa^Fpa      , Aa          , Aa^Fpa      , Aa^Fda      , Aa^Fda      , Aa^Fpa      , Aa^Fda      , Aa          , Aa^Fma      , Aa^Fma      , Aa^Fma      , Aa^Fma      , Aa          , Aa^Fda      , Aa^Fda      , Aa^Fma      , Ms          , Aa^Fma      , Aa^Fma      , Ai          , Aa          , Ai          , Ai          , Ai          , Aa^Fda      , Aa^Fda      , Ha^Fda      , Ms          , Ha^Fda      , Ha^Fda      , Ha          , Aa^Fda      , Aa          , Aa          , Aa^Vha      , Aa          , Aa          , Aa          , Aa          
Aa^Fpa      , Aa^Fpa      , Aa^Fpa      , Aa          , Aa^Fpa      , Aa^Fpa      , Ms          , Aa^Fda      , Aa^Fpa      , Aa^Fda      , Aa^Fda      , Aa          , Aa          , Ha          , Aa^Fma      , Aa^Fda      , Aa^Vha      , Aa^Fma      , Ai          , Aa^Fma      , Ai          , Ai          , Ss          , Ai          , Aa^Fma      , Aa^Fma      , Ai          , Ai          , Ai          , Aa^Fda      , Aa^Fda      , Ha^Fda      , Aa^Fda      , Aa^Fda      , Aa^Fda      , Aa^Fda      , Aa          , Aa          , Aa          , Aa          , Aa          , Aa          
Aa^Fpa      , Aa^Fpa      , Aa^Vha      , Aa          , Ha          , Ha          , Ha          , Ms          , Ms          , Aa^Fpa      , Aa^Fpa      , Aa^Fda      , Aa^Fda      , Aa          , Aa          , Aa^Fma      , Aa^Fma      , Aa^Fma      , Ai          , Ai          , Ai          , Aa^Fma      , Aa^Fma      , Aa^Fma      , Aa^Fma      , Ai          , Aa^Fda      , Aa^Fda      , Aa          , Aa          , Aa^Fda      , Aa^Fda      , Aa          , Aa^Fda      , Aa          , Aa          , Ce          , Ce          , Ce          , Aa          , Aa          , Aa          
Aa^Fpa      , Aa^Fpa      , Aa          , Aa          , Aa          , Ha          , Aa^Vha      , Ha          , Ha          , Ms          , Ms          , Aa^Fda      , Aa^Fda      , Aa^Fma      , Aa          , Aa^Fda      , Aa^Fma      , Ai          , Aa^Fma      , Ai          , Ai          , Aa^Fma      , Aa^Fma      , Aa^Fma      , Aa          , Aa^Fda      , Aa          , Aa^Fda      , Aa^Fda      , Aa          , Aa          , Aa          , Aa          , Aa          , Aa          , Aa          , Ce          , Ce          , 1 Ke        , Aa          , Aa          , Aa          
Aa^Fpa      , Aa^Fpa      , Aa^Fpa      , Aa          , Aa          , Aa          , Aa          , Aa^Fpa      , Ha          , Ms          , Ms          , Ms          , Aa^Fda      , Aa^Fda      , Aa^Fda      , Aa          , Ai          , Ai          , Aa^Fma      , Aa^Fma      , Aa^Fma      , Aa^Fma      , Aa^Fma      , Aa          , Hh          , Aa          , Aa          , Aa^Fda      , Aa^Fda      , Aa          , Aa          , Aa^Fda      , Aa^Fda      , Aa          , Aa          , Aa^Fda      , Aa^Fda      , Ce          , Aa          , Aa          , Aa          , Aa          
Aa^Fpa      , Aa^Fpa      , Aa^Fpa      , Aa^Vha      , Aa^Fpa      , Aa          , Aa          , Aa          , Aa          , Ms          , Ms          , Aa^Fpa      , Ai          , Ai          , Ai          , Ai          , Aa^Fma      , Aa          , Aa          , Aa^Fma      , Aa^Fma      , Aa^Fma      , Aa          , Aa          , Aa          , Hh          , Aa          , Aa          , Aa          , Aa          , Aa          , Aa^Vha      , Aa          , Aa          , Aa^Fda      , Aa^Fda      , Aa          , Aa          , Aa          , Aa          , Aa          , Aa          
Aa^Fpa      , Aa^Fpa      , Aa^Fpa      , Aa^Fpa      , Aa^Fpa      , Aa          , Aa^Fpa      , Aa          , Aa          , Aa^Vha      , Hh          , Aa^Fpa      , Ai          , Aa^Fma      , Aa^Fma      , Aa^Fma      , Aa^Fma      , Aa^Vha      , Aa          , Aa          , Aa^Fma      , Aa          , Aa^Fma      , Aa^Fma      , Aa^Fma      , Aa          , Aa^Fda      , Aa^Fda      , Aa          , Aa          , Aa          , Aa          , Aa          , Aa^Fda      , Aa          , Aa          , Aa          , Aa          , Aa          , Aa          , Aa          , Aa          
Aa^Fpa      , Aa^Fpa      , Aa^Fpa      , Aa^Fpa      , Aa^Fpa      , Aa          , Aa^Fpa      , Aa          , Aa          , Aa          , Hh          , Aa^Fpa      , Ai          , Aa^Fma      , Aa^Fma      , Aa^Fma      , Aa^Fma      , Aa          , Aa          , Aa          , Aa^Fma      , Aa          , Aa^Fma      , Aa^Fma      , Aa^Fma      , Aa          , Aa^Fda      , Aa^Fda      , Aa^Fda      , Aa^Fda      , Aa^Fda      , Mm          , Mm          , Aa          , Mm          , Mm          , Aa          , Aa          , Aa          , Aa          , Aa          , Aa          
