border_size=1
usage=map

Gg          , Gg          , Gg          , Gg          , Gg          , Gg          , Gg          , Gg          , Gg          , Gg          , Gg          , Gg          , Gg          , Gg          , Gg          , Gg          , Gg          , Gg          , Gg          , Gg          , Gg          , Gg          , Gg          , Gg          , Gg          , Gg          , Gg          , Gg          , Gs^Fds      , Gs^Fds      , Gg          , Gg          , Gg          , Gg          , Wwt         , Wwt         , Wwt         , Wwt         , Wwt         , Wwt         , Wwt         , Gg          
Gg          , Gg          , Gg          , Gg          , Gs^Fds      , Gg          , Gs          , Gg          , Gg          , Gg          , Gg          , Gg          , Gg          , Gg          , Gg          , Gg          , Gg          , Gg          , Gg          , Gg          , Gg          , Gg          , Gg          , Gg          , Gg          , Gg          , Gg          , Gg          , Gg          , Gg          , Gg          , Gg          , Gg          , Wwt         , Ww^Ewf      , Wwt         , Wwt         , Wwt         , Wwt         , Wwt         , Gg          , Gg          
Gg          , Gg          , Gg          , Gg          , Gs          , Gs^Fds      , Gs          , Gs          , Gg          , Gg          , Gg          , Gg          , Gg          , Ce          , Gg          , Gg          , Gg          , Gg          , Gg^Ve       , Gg          , Gg          , Gg          , Gg          , Gg          , Gg          , Gg          , Gs          , Gg          , Gg          , Gg          , Gg          , Gg          , Wwt         , Ww^Ewf      , Wwt         , Wwt         , Wwt         , Wwt         , Wwt         , Wwt         , Gg          , Gg          
Gg          , Gg          , Gg          , Gs          , Gs^Fms      , Gs^Fms      , Gs          , Gs          , Gg          , Gg          , Gg          , Ce          , Ce          , Ce          , Ce          , Ce          , Gg          , Gg          , Gg          , Gg          , Gg          , Gg          , Gg          , Gg          , Gs^Fds      , Gs^Fds      , Gs^Fds      , Gg^Ve       , Gg          , Gs^Fms      , Gg          , Gg          , Wwt         , Ww^Ewf      , Wwt         , Wwt         , Wwt         , Wwt         , Wwt         , Wwt         , Gg          , Gg          
Gg          , Gg          , Gg          , Gg          , Gs^Fms      , Gg          , Gg          , Gg          , Gg          , Gg          , Gg          , Gg          , Ce          , 2 Ke        , Ce          , Gg          , Gg          , Gg          , Gg          , Gg          , Gg          , Gg          , Gs^Fds      , Gs^Fds      , Gs          , Gs          , Gs^Fds      , Gg          , Gg          , Gg          , Gg          , Wwt         , Wwt         , Wwt         , Wwt         , Wwt         , Wwt         , Wwt         , Wwt         , Wwt         , Gg          , Gg          
Gg          , Gg          , Gg          , Gg          , Gg          , Gg          , Ce          , Gg          , Gg          , Gg          , Gg          , Ce          , Gg          , Ce          , Gg          , Ce          , Gg          , Gg          , Gg          , Gg          , Gg          , Gg          , Gs          , Gs          , Gg          , Gg          , Gg          , Gg          , Gg          , Gg          , Wwt         , Wwt         , Wwt         , Wwt         , Ww^Ewl      , Wwt         , Wwt         , Wwt         , Gg          , Gg          , Gg          , Gg          
Gg          , Gg          , Gg          , Gg          , Ce          , Gg          , Ce          , Gg          , Ce          , Gg          , Gg          , Gg          , Gg          , Ce          , Gg          , Gg          , Gg          , Gg          , Gg          , Gg          , Gg          , Gg          , Gg          , Gg          , Gg          , Gs^Fms      , Gg          , Gg          , Gg          , Wwt         , Wwt         , Wwt         , Wwt         , Wwt         , Wwt         , Wwt         , Wwt         , Gg          , Gs^Fms      , Gg          , Gg          , Gg          
Gg          , Gg          , Gg          , Gg          , Gg          , Ce          , 1 Ke        , Ce          , Gg          , Gg          , Gg          , Gg          , Gg          , Gg          , Gg          , Gs^Fds      , Gs^Fds      , Gs^Fds      , Gs^Fds      , Gg          , Gg          , Gg          , Gg          , Gg          , Gg          , Gg          , Gg          , Chr         , Wwt         , Wwt         , Wwt         , Wwt         , Wwt         , Wwt         , Wwt         , Wwt         , Gg          , Gg          , Gs^Fms      , Gs^Fds      , Gg          , Gg          
Gg          , Gg          , Gg          , Gg          , Ce          , Ce          , Ce          , Ce          , Ce          , Gg          , Gg^Ve       , Gg          , Gs          , Gg          , Gs          , Gs          , Gs          , Gs          , Gg          , Gg          , Gg          , Gg          , Gg          , Gg          , Gg          , Gg          , Chr         , Chr         , Wwt^Bw\r    , Wwt         , Wwt         , Wwt         , Wwt         , Wwt         , Wwt         , Gg          , Gg          , Gs^Fms      , Gs          , Gs          , Gg          , Gg          
Gg          , Gg          , Gg          , Gg          , Gg          , Gg          , Ce          , Gg          , Gg          , Gg          , Gg          , Gg          , Gs          , Gs          , Gg          , Gg          , Gs          , Gs          , Gg          , Gg          , Gs^Fds      , Gs^Fds      , Gg          , Gg          , Gg          , Gg          , Gg          , Wwt         , Wwt         , Wwt^Bw\r    , Wwt^Bw\r    , Wwt         , Wwt         , Wwt         , Gg          , Gs          , Gs          , Gs^Fms      , Gs^Fms      , Gs          , Gg          , Gg          
Gg          , Gg          , Gg          , Gg          , Gg          , Gg          , Gg          , Gg          , Gg          , Gg          , Gg          , Gg          , Gg          , Gg          , Gg          , Gg          , Gs          , Gg          , Gs          , Gg          , Gs^Fds      , Gg          , Gg          , Gg          , Gg          , Gg          , Wwt         , Wwt         , Wwt         , Wwt         , Wwt         , Wwt^Bw\r    , Wwt^Bw\r    , Wwt         , Chr         , Gg          , Gg          , Gg          , Gg          , Gs          , Gg^Ve       , Gg          
Gg          , Gg          , Gg          , Gg          , Gg          , Gg          , Gg          , Gg          , Gg          , Gg          , Gg          , Gg          , Gs^Fds      , Gs^Fds      , Gs^Fds      , Gs^Fds      , Gs^Fds      , Gg          , Gg^Efm      , Gs          , Gg^Efm      , Gg          , Gg          , Gg          , Gg          , Gg          , Wwt         , Wwt         , Wwt         , Ww^Ewl      , Wwt         , Wwt         , Chr         , Chr         , Gg          , Gg          , Gs^Fds      , Gg          , Gg          , Gs^Efm      , Gg          , Gg          
Gg          , Gg          , Gg          , Gs^Fms      , Gs^Fms      , Gs^Fms      , Gs          , Gg          , Gg          , Gg          , Gs^Fms      , Gs^Fds      , Gg          , Gg          , Gs          , Gg          , Gs^Efm      , Gs^Efm      , Gg          , Gg^Efm      , Gg          , Gg          , Gg          , Gg          , Gg          , Wwt         , Wwt         , Ww^Ewf      , Wwt         , Ww^Ewl      , Wwt         , Wwt         , Gg^Ve       , Gg          , Gg          , Gg          , Gs^Fds      , Gg          , Gg^Efm      , Gg^Efm      , Gg          , Gg          
Gg          , Gg          , Gs^Fds      , Gg          , Gs^Fds      , Gs          , Gs^Fds      , Gs          , Gg          , Gg          , Gs^Fms      , Gg          , Gs          , Gs          , Gg          , Gs          , Gg^Efm      , Gg          , Gg          , Gg          , Gg          , Gg          , Gg          , Gg          , Wwt         , Wwt         , Wwt         , Ww^Ewf      , Wwt         , Wwt         , Wwt         , Gg          , Gg^Ve       , Gg          , Gg          , Gg          , Gs^Fds      , Gg          , Gg          , Gg          , Gg          , Gg          
Gg          , Gs          , Gs^Fms      , Gs^Fms      , Gs^Fms      , Gs^Fds      , Gg          , Gs^Fds      , Gg          , Gs          , Gs^Fms      , Gs          , Gs          , Gs          , Gg          , Gg          , Gg^Efm      , Gg^Ve       , Gg          , Gg          , Gg          , Gg          , Gg          , Wwt         , Wwt         , Wwt         , Ww^Ewf      , Ww^Ewf      , Wwt         , Wwt         , Gg          , Gg          , Gg          , Gg          , Gs^Fms      , Gg          , Gg^Efm      , Gs^Fds      , Gg^Efm      , Gg          , Gg          , Gg          
Gg          , Gg          , Gg          , Gs^Fms      , Gg          , Gs^Fms      , Gs^Fms      , Gg          , Gg          , Gg          , Gg          , Gg          , Gg          , Gg          , Gg          , Gg          , Gg^Efm      , Gg          , Gs^Fms      , Gg          , Gg          , Gg          , Wwt         , Wwt         , Wwt         , Wwt         , Wwt         , Wwt         , Wwt         , Wwt         , Gg          , Gg          , Gg          , Gg          , Gg          , Gg^Ve       , Gg^Efm      , Gs^Fds      , Gg          , Gg          , Gs^Fms      , Gg          
Gg          , Gg          , Gg          , Gg          , Gg          , Gg          , Gg          , Gg          , Gg^Ve       , Gg          , Gg          , Gg          , Gg          , Gg          , Gg          , Gg          , Gg          , Gs^Fms      , Gg          , Gg          , Gg          , Gg          , Wwt         , Wwt         , Wwt         , Wwt         , Wwt         , Wwt         , Gg          , Gg          , Gg          , Gg          , Gg          , Gg          , Gg^Efm      , Gg^Ve       , Gg          , Gg^Efm      , Gg          , Gs          , Gs^Fms      , Gg          
Gg          , Gg          , Gg          , Gg          , Gg          , Gg          , Gg          , Gg          , Gg          , Gg          , Gg          , Gg          , Gg          , Gg          , Gg          , Gg          , Gg          , Gg          , Gg          , Gg          , Gg          , Wwt         , Wwt         , Wwt         , Wwt         , Wwt         , Wwt         , Wwt         , Gg          , Gg          , Gs^Fms      , Gg          , Gg^Efm      , Gg^Efm      , Gg          , Gg          , Gg          , Gg          , Gs^Fms      , Gs^Fms      , Gg          , Gg          
Gg          , Gg          , Gg          , Gg          , Gg          , Gg          , Gg          , Gg          , Gg          , Gg          , Gg          , Gg          , Gg          , Gg          , Gg          , Gg          , Gg          , Gg          , Gg          , Chr         , Wwt         , Wwt         , Wwt         , Wwt         , Wwt         , Wwt         , Wwt         , Gg          , Gg          , Gg          , Gg          , Gs^Fms      , Gs^Fms      , Gs^Fms      , Gs^Efm      , Gs          , Gs^Efm      , Gs^Fms      , Gs^Fms      , Gs^Fms      , Gg          , Gg          
Ch          , Ch          , Ch          , Ch          , Ch          , Kh^Cov      , Ch          , Ch          , Ch          , Ch          , Ch          , Ch          , Gg          , Ch          , Ch          , Kh^Cov      , Ch          , Ch          , Chr         , Chr         , Wwt^Bw\r    , Wwt         , Wwt         , Wwt         , Wwt         , Wwt         , Gg          , Gg          , Gg          , Gg          , Gg          , Gg          , Gg          , Gg^Efm      , Gg          , Gg^Efm      , Gg          , Gg          , Gg          , Gg          , Gg          , Gg          
Gg          , Gg          , Gg          , Gg          , Gg          , Gg          , Gg          , Gg          , Gg          , Gg          , Gg          , Gg          , Gg          , Gg          , Gg          , Gg          , Gg          , Gg          , Wwt         , Wwt         , Wwt         , Wwt^Bw\r    , Wwt^Bw\r    , Wwt         , Wwt         , Wwt         , Gg          , Gg          , Gg          , Gg          , Gg          , Gg          , Gg          , Gg          , Gg          , Gg          , Gg          , Gg          , Gg^Ve       , Gg          , Gg          , Gg          
Gg          , Gg          , Gg          , Gs^Fms      , Gs^Fms      , Gg          , Gg          , Gg          , Gg          , Gg          , Gg          , Gg          , Gg          , Gg          , Gg          , Gg          , Gg          , Wwt         , Ww^Ewl      , Wwt         , Wwt         , Wwt         , Wwt         , Wwt^Bw\r    , Chr         , Chr         , Gg          , Gg          , Gg          , Gg^Efm      , Gg          , Gs^Fds      , Gg          , Gg          , Gg          , Gg          , Gg          , Gg          , Gg          , Gg          , Gg          , Gg          
Gg          , Gg          , Gg          , Gs^Fms      , Gs^Fms      , Gs^Fms      , Gs^Fms      , Gs^Fms      , Gs^Efm      , Gg          , Gg          , Gg          , Gg          , Gg          , Gg          , Gg          , Wwt         , Wwt         , Wwt         , Ww^Ewl      , Wwt         , Wwt         , Wwt         , Wwr         , Chr         , Gg          , Gg          , Gg          , Gg          , Gg^Efm      , Gg          , Gs^Fds      , Gg          , Gg          , Ce          , Ce          , Ce          , Gg          , Gg          , Gg          , Gg          , Gg          
Gg          , Gg          , Gg          , Gg          , Gg          , Gg          , Gg          , Gs          , Gg          , Gg          , Gg^Efm      , Gs^Efm      , Gg          , Gg          , Gg          , Gg          , Wwt         , Ww^Ewl      , Wwt         , Wwt         , Wwt         , Wwt         , Wwt         , Gg          , Gg          , Gg          , Gg          , Gg          , Gg          , Gg^Efm      , Gg          , Gg          , Gg          , Gg          , Ce          , 5 Ke        , Ce          , Gg          , Gg          , Gg          , Gg          , Gg          
Gg          , Gg          , Gg          , Gg          , Gg          , Gg          , Gg          , Gg          , Gg          , Gs^Fds      , Gg^Efm      , Gg          , Gg          , Gg          , Wwt         , Wwt         , Wwt         , Wwt         , Ww^Ewl      , Wwt         , Wwt         , Wwt         , Gg          , Gg          , Gg          , Gg          , Gg^Ve       , Gg          , Gg          , Gg^Efm      , Gg^Efm      , Gs^Fms      , Gg          , Gg          , Gg          , Ce          , Gg          , Gg          , Gs^Fms      , Gg          , Gg          , Gg          
Gg          , Gg          , Gg          , Gg          , Ce          , Gg          , Gg          , Gg          , Gg^Ve       , Gg          , Gg          , Gg          , Gg          , Gg          , Wwt         , Wwt         , Wwt         , Wwt         , Wwt         , Wwt         , Wwt         , Gg          , Gg          , Gg          , Gg          , Gg          , Gg          , Gg          , Gs          , Gg          , Gs          , Gg^Efm      , Gs^Efm      , Gg          , Gg          , Gg          , Gg          , Gg          , Gs^Fms      , Gg          , Gg          , Gg          
Gg          , Gg          , Ce          , Gg          , Ce          , Gg          , Ce          , Gg          , Gg          , Gg          , Gs^Efm      , Gg          , Gg          , Gg          , Wwt         , Ww^Ewl      , Wwt         , Wwt         , Wwt         , Wwt         , Gg          , Gg          , Gg          , Gg          , Gg          , Gg          , Gg          , Gs^Fms      , Gg          , Gs^Efm      , Gg          , Gs          , Gg          , Gg          , Gg          , Gg          , Gg          , Gs^Fms      , Gg          , Gg          , Gg^Ve       , Gg          
Gg          , Gg          , Gg          , Ce          , 3 Ke        , Ce          , Gg          , Gg          , Gg          , Gg^Efm      , Gg^Efm      , Gg          , Gg          , Wwt         , Wwt         , Ww^Ewl      , Wwt         , Wwt         , Wwt         , Wwt         , Gg          , Gg          , Gg          , Gg          , Gg          , Gg          , Gs^Fms      , Gs^Fms      , Gg          , Gg          , Gg          , Gg          , Gg          , Gg          , Ce          , Gg          , Gg          , Gg          , Gg          , Gg          , Gg          , Gg          
Gg          , Gg          , Ce          , Ce          , Ce          , Ce          , Ce          , Gg          , Gg^Ve       , Gg          , Gg          , Gg          , Wwt         , Wwt         , Wwt         , Ww^Ewl      , Wwt         , Wwt         , Wwt         , Gg          , Gg          , Gg          , Gg          , Gg          , Gs^Fds      , Gg          , Gs          , Gs^Fms      , Gg          , Gg          , Gg          , Gg          , Gg          , Ce          , 6 Ke        , Ce          , Gg          , Gg          , Gg          , Gg          , Gg          , Gg          
Gg          , Gg          , Gg          , Gg          , Ce          , Gg          , Gg          , Gg          , Gg          , Gg          , Gg          , Gg          , Wwt         , Ww^Ewf      , Wwt         , Ww^Ewl      , Wwt         , Wwt         , Wwt         , Gg          , Gg          , Gg          , Gs^Fds      , Gs^Fds      , Gg          , Gs^Fds      , Gs          , Gg          , Gg          , Gg          , Gg          , Gg          , Gg          , Ce          , Ce          , Ce          , Gg          , Gg          , Gg          , Gg          , Gg          , Gg          
Gg          , Gg          , Gg          , Gg          , Gg          , Gg          , Gs^Fms      , Gs^Fms      , Gg          , Gg          , Chr         , Wwt         , Wwt         , Wwt         , Ww^Ewl      , Wwt         , Wwt         , Wwt         , Gg          , Gg          , Gg          , Gs^Fds      , Gg          , Gg          , Gg^Efm      , Gg^Ve       , Gg          , Gg          , Gg          , Gg          , Ce          , Gg          , Gg          , Gg          , Gg          , Gg          , Gg          , Gs^Fds      , Gs^Fds      , Gg          , Gg          , Gg          
Gg          , Gg          , Gg          , Gg          , Gs^Efm      , Gs^Efm      , Gs^Fms      , Gs^Fms      , Gg          , Gg          , Chr         , Wwt         , Wwt         , Wwt         , Wwt         , Wwt         , Wwt         , Gg          , Gg          , Gg          , Gg          , Gg          , Gg          , Gg          , Gs^Efm      , Gs          , Gs^Fms      , Gg          , Gg          , Ce          , 4 Ke        , Ce          , Gg          , Gg          , Gg          , Gg          , Gg          , Gs^Fds      , Gg          , Gg          , Gg          , Gg          
Gg          , Gg          , Gg          , Gg^Efm      , Gg^Efm      , Gg          , Gs^Fms      , Gg          , Gg          , Chr         , Wwt         , Wwt^Bw\r    , Wwt^Bw\r    , Wwt         , Wwt         , Wwt         , Gg          , Gg          , Gg          , Gg          , Gg          , Gg          , Gg          , Gg          , Gs^Fms      , Gs^Fms      , Gg          , Gg          , Gg          , Ce          , Ce          , Ce          , Gg          , Gg          , Gg          , Gg          , Gg          , Gg          , Gg^Ve       , Gg          , Gg          , Gg          
Gg          , Gg          , Gg^Efm      , Gs^Fds      , Gs^Fds      , Gs^Fms      , Gg          , Gg          , Gg          , Gg          , Wwt         , Wwt         , Wwt         , Wwt^Bw\r    , Wwt^Bw\r    , Wwt         , Chr         , Gg          , Gg          , Gg          , Gg^Ve       , Gg          , Gs^Fms      , Gs^Fms      , Gg          , Gs^Fms      , Gg          , Gg          , Gg          , Gg          , Gg          , Gg          , Gg          , Gg          , Gg          , Gg          , Gs^Fms      , Gg          , Gg          , Gg          , Gg          , Gg          
Gg          , Gg          , Gg^Efm      , Gg^Efm      , Gg          , Gg          , Gg          , Gg          , Gg          , Gg          , Ww^Ewf      , Wwt         , Wwt         , Wwt         , Wwt         , Wwt^Bw\r    , Chr         , Gg          , Gg          , Gg          , Gg          , Gs^Fms      , Gs^Fms      , Gg^Efm      , Gg          , Gg          , Gg          , Gg          , Gg          , Gg          , Gg          , Gg          , Gs^Fms      , Gg          , Gs^Fms      , Gs^Fms      , Gs^Fms      , Gg          , Gg          , Gg          , Gg          , Gg          
Gg          , Gg          , Gg^Efm      , Gs^Fms      , Gs^Fms      , Gg          , Gg          , Gg^Ve       , Gg          , Ww^Ewf      , Wwt         , Wwt         , Wwt         , Ww^Ewl      , Wwt         , Wwt         , Chr         , Gg          , Gg          , Gg          , Gg          , Gg          , Gs^Fms      , Gg^Efm      , Gg          , Gg          , Gg^Efm      , Gg          , Gg          , Gg          , Gg          , Gg          , Gg          , Gs^Fms      , Gg          , Gg          , Gg          , Gg          , Gg          , Gg          , Gg          , Gg          
Gg          , Gg          , Gg          , Gg          , Gg          , Gs^Fms      , Gg          , Gg          , Wwt         , Wwt         , Wwt         , Ww^Ewl      , Wwt         , Wwt         , Wwt         , Gg          , Gg          , Gg          , Gg          , Gg          , Gg          , Gg          , Gg          , Gs^Fms      , Gg          , Gg          , Gg          , Gs          , Gs^Fms      , Gs^Fms      , Gs^Fms      , Gg          , Gg          , Gg          , Gg          , Gg          , Gg          , Gg          , Gg          , Gg          , Gg          , Gg          
Gg          , Gg          , Gg          , Gg          , Gg          , Gg          , Gg          , Gg          , Wwt         , Wwt         , Wwt         , Wwt         , Wwt         , Wwt         , Gg          , Gg          , Gg          , Gg          , Gg          , Gg          , Gg          , Gg          , Gg          , Gg          , Gg          , Gg          , Gg          , Gg          , Gg          , Gg          , Gg          , Gg          , Gg          , Gg          , Gg          , Gg          , Gg          , Gg          , Gg          , Gg          , Gg          , Gg          
