border_size=1
usage=map

Gg          , Gg          , Gg          , Gg          , Gg          , Gg          , Gg          , Gg          , Gg          , Gg          , Gg          , Gg          , Gg          , Gg          , Gg          , Gg          , Gg          , Ggf         , Ggf         , Gg          , Gg          , Mm          , Mm          , Hh^Fmf      , Gg          , Gg          , Mm          , Hh          , Mm          , Gg          , Ggf         , Gg^Vh       , Gg          , Gg          , Chr         , Chr         , Khr^Dr      , Chr         , Chr         , Re          , Ggf         , Gg          , Gs^Fms      , Gs^Fms      , Gg          , Gg          , Mm          , Mm          , Gg          , Gg          , Gg          , Gg          , Gg          , Gs^Fms      , Gg          , Hh^Fmf      
Gg          , Gg          , Gg          , Gg          , Re^Gvs      , Gg          , Gg          , Gg          , Gg          , Gg          , Gg          , Gg          , Re^Vct      , Gg          , Gg          , Ggf         , Ggf         , Ggf         , Gg          , Gg          , Mm          , Hh          , Hh^Fmf      , Gs^Fms      , Re^Vct      , Gg          , Gg          , Rd          , Rd          , Rd          , Rd          , Rd          , Rd          , Rd          , Rd^Dr       , Chr         , Chr^Dr      , Chr         , Rd          , Rd          , Rd          , Rd          , Rd          , Rd          , Gg          , Gg          , Gg          , Mm          , Mm          , Gg          , Gg          , Gg          , Gs^Fmw      , Gs^Fms      , Hh^Fms      , Hh^Fmf      
Gg          , Gg          , Gg          , Re^Gvs      , Re^Gvs      , Re^Gvs      , Re^Gvs      , Gg          , Gg          , Gg          , Gg          , Gg          , Gg          , Gg          , Gg          , Gg          , Ggf         , Re^Vct      , Gg          , Hh          , Mm          , Mm          , Mm          , Rd          , Hh^Fmf      , Rd          , Rd          , Gg          , Gg          , Gg          , Re^Vct      , Ggf         , Rp          , Rp          , Gg^Dr       , Re          , Chr         , Re          , Gg^Dr       , Ggf         , Rd          , Rp          , Gg          , Gg          , Rd          , Rd          , Ce          , Ce          , Ce          , Gg          , Gg          , Gg          , Gs^Fmf      , Gs^Fmf      , Gs^Fmf      , Ggf         
Gg          , Gg          , Gg          , Gg          , Gg          , Re^Gvs      , Re^Gvs      , Re^Gvs      , Re^Gvs      , Gg          , Gg          , Gg          , Gg          , Gs^Fmf      , Gs^Fmf      , Gg          , Gg          , Gg          , Gg          , Gg          , Hh          , Rp          , Ce          , Gg          , Rd          , Hh^Fmw      , Gg          , Gg          , Gg          , Ggf         , Ww          , Ggf         , Rp          , Rp          , Rp          , Gg          , Ww          , Ww          , Ww          , Ww          , Ww          , Ww          , Ww          , Gg          , Gg          , Gg          , Rd          , Ce          , 5 Ke        , Rd          , Gg          , Gg^Vh       , Gg          , Ggf         , Ggf         , Ggf         
Gg          , Gg          , Gg          , Gg          , Gg^Vh       , Gg          , Gg          , Re^Gvs      , Re^Gvs      , Re^Gvs      , Re^Vct      , Gg          , Gg          , Gs^Fmf      , Gs^Fms      , Gg          , Gg          , Re^Vct      , Gg          , Re^Vct      , Ce          , Ce          , Ce          , Re^Vct      , Gg          , Gg          , Gg          , Gg          , Ww          , Ww          , Ww          , Ww          , Ww          , Ww          , Ww          , Ww          , Ww          , Ww          , Ww          , Ww          , Ww          , Ww          , Ww          , Gg          , Gg          , Gg          , Gg          , Gg          , Rd          , Rd          , Gg          , Gg          , Gg          , Ggf         , Gg          , Gg^Vh       
Gg          , Gg          , Gg          , Gg          , Gg          , Gg          , Gg          , Gg          , Gg          , Gg          , Gg          , Gs^Fms      , Gs^Fms      , Gs^Fms      , Gs^Fms      , Gg          , Hh^Fmw      , Rd          , Hh^Fmw      , Gg^Vh       , Ce          , Ce          , 2 Ke        , Ce          , Ww          , Ww          , Ww          , Ww          , Ww          , Ww          , Ww          , Ww          , Ww          , Ww          , Ww          , Ww          , Ww          , Ww          , Ww          , Ww          , Ww          , Ww          , Ww          , Ww          , Ww          , Gg          , Ww          , Gg          , Gg          , Gg          , Rd          , Rd          , Gg          , Ggf         , Ggf         , Ggf         
Gg          , Gg          , Gg          , Gg          , Gg          , Gg          , Gg          , Gg          , Gg          , Gg          , Gg          , Gs^Fms      , Gs^Fms      , Gg          , Gg          , Hh^Fmw      , Rd          , Hh^Fmw      , Hh^Fmw      , Gg          , Ce          , Ce          , Ce          , Ww          , Ww          , Ww          , Ww          , Ww          , Ww          , Ww          , Ww          , Ww          , Ww          , Ww          , Ww          , Ww          , Ww          , Ww          , Ww          , Ww          , Ww          , Ww          , Ww          , Ww          , Ww          , Ww          , Ww          , Ww          , Ww          , Ce          , Ce          , Rr          , Rd          , Rd          , Gg          , Gg          
Gg          , Gg          , Gg          , Gg          , Gg          , Gg          , Gg          , Gg          , Gg          , Gg          , Gg          , Gg          , Gs^Fmf      , Gg          , Gg          , Rd          , Re^Gvs      , Gg          , Gg          , Gg          , Gg          , Gg          , Ww          , Ww          , Ww          , Ww          , Ww          , Ww          , Ww          , Ww          , Ww          , Ww          , Cud         , Cud         , Cud         , Cud         , Cud         , Cud         , Cud         , Cud         , Cud         , Cud         , Cud         , Ww          , Ww          , Ww          , Ww          , Ww          , Ww          , Ww          , Ww          , Ce          , Gg          , Gg          , Rd          , Rd          
Rr          , Gg          , Gg          , Gg          , Gg          , Gg          , Gg          , Gg          , Gg          , Gg          , Gg          , Gg          , Gg          , Gg          , Re^Gvs      , Re^Gvs      , Re^Gvs      , Re^Gvs      , Re^Gvs      , Re^Vct      , Gg          , Ds          , Ww          , Ww          , Ww          , Ww          , Ww          , Ww          , Cud         , Cud         , Cud         , Cud         , Mm          , Mm          , Mm          , Mm          , Mm          , Mm          , Mm          , Mm          , Mm          , Mm          , Mm          , Cud         , Cud         , Ww          , Ww          , Ww          , Ww          , Ww          , Ww          , Ww          , Ww          , Ds          , Rd          , Rd          
Rr          , Rr          , Rr          , Gg          , Gg          , Gg          , Rr          , Rr          , Rr          , Gg          , Gg          , Gg          , Gg          , Re^Gvs      , Re^Gvs      , Re^Gvs      , Re^Gvs      , Re^Gvs      , Gg          , Ggf         , Gg          , Ds          , Ds          , Ww          , Ww          , Ww          , Ww          , Ww          , Cud         , Mm          , Mm          , Mm          , Ww          , Ww          , Ww          , Ww          , Ww          , Ww          , Ww          , Ww          , Ww          , Ww          , Ww          , Mm          , Mm          , Cud         , Cud         , Ww          , Ww          , Ww          , Ww          , Ww          , Ww          , Ww          , Ww          , Ggf         
Gg          , Rr          , Rr          , Rr          , Rr          , Rr          , Rr          , Rr          , Rr          , Rr          , Rr          , Gg          , Gg          , Gg          , Gg          , Re^Gvs      , Gg          , Gg          , Gg          , Gs^Fms      , Gs^Fms      , Gs^Fmf      , Gg          , Ww          , Ww          , Ww          , Ww          , Ww          , Cud         , Mm          , Ww          , Ww          , Gg^Vh       , Co          , Co          , Mm          , Mm          , Gs^Fmf      , Gs^Fms      , Ko          , Gg^Vh       , Gg          , Hh          , Ww          , Ww          , Mm          , Mm          , Cud         , Ww          , Ww          , Ww          , Ww          , Ww          , Ww          , Ww          , Gs^Fms      
Gg          , Gg          , Gg          , Rr          , Rr          , Rr          , Gg          , Gg          , Gg          , Rr          , Rr          , Gg^Vh       , Rr          , Gg          , Gg          , Gg          , Rd          , Gg          , Gg          , Gs^Fms      , Gs^Fmf      , Gs^Fmf      , Ce          , Ww          , Ww          , Ww          , Ww          , Cud         , Mm          , Mm          , Ww          , Gs^Fmf      , Gg          , Re^Gvs      , Re^Gvs      , Re^Gvs      , Ko          , Ko          , Gg          , Ko          , Gg          , Ko          , Ko          , Gs^Fms      , Ww          , Mm          , Mm          , Cud         , Cud         , Ww          , Ww          , Ww          , Ww          , Ww          , Ww          , Gs^Fmf      
Gg          , Gg          , Gg          , Gg          , Gg          , Gg          , Gg          , Gg          , Gg          , Rr          , Rr          , Rr          , Rr          , Rr          , Rr          , Gg          , Gg          , Gg          , Gg          , Gg          , Gs^Fmf      , Gg          , Gg          , Ww          , Ww          , Ww          , Ww          , Cud         , Mm          , Ww          , Ww          , Co          , Re^Gvs      , Gg^Wm       , Re^Gvs      , Re^Gvs      , Re^Gvs      , Gg          , Ko          , Ko          , Ko          , Gg          , Gg          , Co          , Gs^Fmf      , Ww          , Ww          , Mm          , Mm          , Cud         , Cud         , Ww          , Ww          , Ww          , Ww          , Ww          
Gg          , Gg          , Gg          , Gg          , Gg          , Gg          , Gg          , Gg          , Gg          , Gg          , Gg          , Rr          , Ggf         , Rr          , Rr          , Rr          , Rr          , Gg          , Gg          , Gg          , Gg          , Gg          , Gg          , Ww          , Ww          , Ww          , Ww          , Cud         , Cud         , Mm          , Ww          , Co          , Re^Gvs      , Re^Gvs      , Re^Gvs      , Gg          , Gg          , Ko          , Ko          , 4 Co^Kov    , Ko          , Ko          , Gg          , Gg          , Gg^Vh       , Co          , Co          , Ww          , Ww          , Mm          , Cud         , Ww          , Ww          , Ww          , Ww          , Ww          
Gg          , Gg          , Gg          , Gg          , Gg          , Gg^Vh       , Gg          , Gg          , Gg          , Gg          , Gg          , Gg          , Ggf         , Ggf         , Gg          , Rr          , Rr          , Rr          , Rr          , Gg          , Gg          , Gg          , Gg          , Ww          , Ww          , Ww          , Ww          , Ww          , Cud         , Mm          , Ww          , Co          , Co          , Gg          , Gg          , Gg          , Ko          , Gg          , Gg          , Ko          , Mm          , Gg          , Ko          , Gg          , Gg          , Gs^Fms      , Gg          , Co          , Ww          , Mm          , Chw         , Ww          , Ww          , Ww          , Ww          , Ww          
Gg          , Gg          , Gg          , Gg          , Gg          , Gg          , Gg          , Gg          , Re^Gvs      , Re^Gvs      , Re^Gvs      , Gg          , Ggf         , Ggf         , Gg          , Gg          , Gg          , Rr          , Rr          , Rr          , Rr          , Gg          , Rr          , Rr          , Ww          , Ww          , Ww          , Ww          , Cud         , Mm          , Mm          , Ww          , Ww          , Gg^Vh       , Gs^Fms      , Gs^Fms      , Gg          , Mm          , Gg          , Ko          , Gg          , Gg^Vh       , Gg          , Ko          , Ko          , Gs^Fmf      , Co          , Co          , Ww          , Ww          , Chw         , Ww          , Ww          , Ww          , Ww          , Ww          
Gg          , Gg          , Gg          , Gg          , Gg          , Gg          , Re^Gvs      , Re^Gvs      , Re^Gvs      , Re^Gvs      , Re^Gvs      , Re^Gvs      , Gg          , Gg          , Gg          , Gg          , Gg          , Gg          , Gg          , Rr          , Rr          , Rr          , Rr          , Rr          , Ww          , Ww          , Ww          , Ww          , Ww          , Cud         , Cud         , Mm          , Ww          , Ww          , Gs^Fmf      , Gg          , Gg          , Gg          , Gg          , Gg          , Gg          , Gs^Fms      , Ko          , Ko          , Ko          , Gg^Vh       , Ww          , Ww          , Mm          , Mm          , Cud         , Ww          , Ww          , Ww          , Ww          , Ww          
Gg          , Gg          , Gg          , Gg          , Re^Gvs      , Re^Gvs      , Re^Gvs      , Re^Gvs      , Re^Gvs      , Re^Gvs      , Gg          , Gg          , Gg          , Gg          , Gg          , Gg          , Gg          , Gg          , Gg          , Rp          , Gg          , Rr          , Ggf         , Ggf         , Gg          , Ww          , Ww          , Ww          , Ww          , Ww          , Cud         , Mm          , Mm          , Ww          , Ww          , Hh          , Gg^Vl       , Gg          , Co          , Gg          , Gs^Fms      , Gs^Fms      , Ko          , Ko          , Ww          , Ww          , Mm          , Mm          , Cud         , Mm          , Cud         , Ww          , Ww          , Ww          , Ww          , Ww          
Gg          , Gg          , Gg          , Gg          , Gg          , Re^Gvs      , Re^Gvs      , Re^Gvs      , Gg          , Gg^Wm       , Gg          , Gg          , Gg          , Gg          , Gg          , Gg          , Gg          , Gg          , Gg          , Rp          , Gg          , Gg          , Gg^Vh       , Gg          , Gg          , Gg          , Gg          , Ww          , Ww          , Ww          , Ww          , Cud         , Cud         , Mm          , Mm          , Ww          , Ww          , Co          , Ww          , Gg^Vh       , Ww          , Ww          , Ww          , Ww          , Mm          , Mm          , Cud         , Cud         , Ww          , Cud         , Ww          , Ww          , Ww          , Ww          , Ww          , Ww          
Gg          , Gg          , Gg          , Gg          , Gg          , Gg          , Gg          , Gg          , Gg          , Gg          , Gg          , Gg          , Gg          , Gg          , Gg          , Gs^Fms      , Gs^Fms      , Gg          , Gg          , Rp          , Gg          , Gg          , Gg          , Gg          , Gg          , Gg          , Gg          , Ww          , Ww          , Ww          , Ww          , Ww          , Ww          , Cud         , Cud         , Mm          , Mm          , Ww          , Mm          , Ww          , Mm          , Mm          , Mm          , Mm          , Cud         , Cud         , Ww          , Ww          , Ww          , Ww          , Ww          , Ww          , Ww          , Ww          , Ww          , Ww          
Gg          , Gg          , Gg          , Gg          , Gg          , Gg          , Gg          , Gg          , Gg          , Gg          , Gg          , Gg          , Gg          , Gs^Fms      , Gs^Fms      , Gs^Fms      , Gg          , Hh^Fms      , Gg          , Gg          , Gg          , Gg          , Gg          , Gg          , Gg          , Gg          , Gg          , Ww          , Ww          , Ww          , Ww          , Ww          , Ww          , Ww          , Ww          , Cud         , Cud         , Mm          , Cud         , Mm          , Cud         , Cud         , Cud         , Cud         , Ww          , Ww          , Ww          , Ww          , Ww          , Ww          , Ww          , Ww          , Ww          , Ww          , Ww          , Ww          
Gg          , Gg          , Gg          , Gg          , Gg          , Ce          , Gg          , Gg          , Gg          , Gg          , Gg^Vh       , Gg          , Gs^Fms      , Gs^Fmf      , Gs^Fms      , Hh^Fms      , Hh^Fms      , Mm          , Mm          , Rp          , Gg          , Rp          , Gg          , Gg          , Gs^Fmf      , Gg          , Gs^Fms      , Gg          , Ww          , Ww          , Ww          , Ww          , Ww          , Ww          , Ww          , Ww          , Ww          , Cud         , Ww          , Cud         , Ww          , Ww          , Ww          , Ww          , Ww          , Ww          , Ww          , Ww          , Ww          , Ww          , Ww          , Ww          , Ce          , Ce          , Ww          , Ww          
Gg          , Gg          , Gg          , Ce          , Ce          , Ce          , Ce          , Ce          , Gg          , Gg          , Gg          , Gg          , Gs^Fms      , Gs^Fmf      , Gs^Fmf      , Mm          , Mm          , Mm          , Mm          , Rp          , Gg          , Rp          , Gg          , Gg          , Gs^Fms      , Gs^Fms      , Gs^Fms      , Gg          , Ce          , Ww          , Ww          , Ww          , Ww          , Ww          , Ww          , Ww          , Ww          , Ww          , Ww          , Ww          , Ww          , Ww          , Ww          , Ww          , Ww          , Ww          , Ww          , Ww          , Ww          , Ww          , Gg          , Gs^Fms      , Ce          , Gg          , Rr          , Rd          
Gg          , Gg          , Gg          , Gg          , Ce          , 1 Ke        , Ce          , Gg          , Gg          , Gg          , Gg          , Gg          , Gg          , Gg          , Hh^Fmf      , Hh^Fmf      , Mm          , Hh          , Hh          , Rp          , Gg          , Gg          , Gg          , Gg          , Gg          , Gg          , Gs^Fms      , Gg          , Ce          , Gg          , Gg          , Ww          , Ww          , Ww          , Ww          , Ww          , Ww          , Ww          , Ww          , Ww          , Ww          , Ww          , Ww          , Ww          , Ww          , Ww          , Ww          , Ww          , Ww          , Gs^Fms      , Gs^Fms      , Gs^Fms      , 3 Ke        , Gg          , Gg          , Rd          
Gg          , Gg          , Gg          , Ce          , Gg          , Ce          , Gg          , Ce          , Gg          , Gg          , Gg          , Gg          , Re^Gvs      , Re^Gvs      , Re^Gvs      , Ggf         , Ggf         , Gg          , Gg          , Gg          , Rp          , Gg          , Gg          , Gg^Vh       , Gg          , Ggf         , Gg          , Gg          , Gg          , Gs^Fms      , Gg          , Gg          , Gg          , Ww          , Ww          , Ww          , Ww          , Ww          , Ww          , Ww          , Ww          , Ww          , Ww          , Ww          , Ww          , Ww          , Ds          , Ds          , Ds          , Gs^Fmf      , Ce          , Ce          , Gs^Fms      , Rd          , Rd          , Gs^Fms      
Gg          , Gg          , Gg          , Gg          , Gg          , Ce          , Gg          , Gg          , Gg          , Gg          , Gg          , Re^Gvs      , Re^Gvs      , Gg^Wm       , Re^Gvs      , Re^Gvs      , Ggf         , Gg          , Gg          , Rp          , Rp          , Gg          , Gg          , Gg          , Gg          , Gg          , Gg          , Gg          , Gs^Fms      , Gs^Fmf      , Gs^Fms      , Gg          , Gg          , Gg          , Gg          , Ww          , Ww          , Ww          , Ww          , Ww          , Ww          , Ww          , Ww          , Ww          , Gg          , Gg          , Gg          , Gg          , Gg          , Ce          , Gs^Fms      , Rp          , Rp          , Gg          , Gg          , Gs^Fmf      
Gg          , Gg          , Gg          , Gg          , Gg          , Gg          , Gg          , Gg          , Gg          , Gg          , Gg          , Gg          , Gg          , Re^Gvs      , Gg          , Gg          , Gg          , Gg          , Gg          , Rp          , Rp          , Gg          , Gg          , Gg          , Gg          , Gg          , Gg          , Gg          , Gs^Fms      , Gs^Fmf      , Gs^Fms      , Gs^Fms      , Gg          , Gg          , Gg          , Ds          , Ds          , Ww          , Ww          , Ww          , Ce          , Gs^Fms      , Gg          , Gs^Fms      , Gg          , Gg^Vh       , Gg          , Gg          , Gg          , Ce          , Rp          , Rp          , Gg          , Gg          , Gg          , Gg          
Gg          , Gg          , Gg          , Gg          , Gg          , Gg          , Gg          , Gg          , Gg          , Gg          , Gg          , Gg          , Gg          , Gg          , Gg          , Gg          , Gg          , Gg          , Gg          , Rp          , Rp          , Rp          , Rp          , Gg          , Gg^Vh       , Gg          , Gg          , Gg          , Gg          , Gg          , Gg          , Gg          , Gg          , Mm          , Hh          , Gg          , Gg          , Ggf         , Ce          , Ce          , Ce          , Gg          , Gs^Fms      , Gg          , Gg          , Gg          , Gg          , Rd          , Rd          , Rp          , Rd          , Hh^Fds      , Gg          , Gg          , Gg          , Ggf         
