border_size=1
usage=map

Gll         , Cv          , Gll^Fp      , Gll^Fp      , Gll^Fp      , Gll         , Gll         , Gll         , Gll         , Gll         , Gll         , Gll         , Gll^Fp      , Gll         , Gll         , Gll         , Hh^Fds      , Hh^Fds      , Gll         , Gll         , Gll         , Gll         , Gll         , Gll         , Gll         , Gll         , Gll         , Gll         , Gll         , Gll         , Gll^Fmf     , Gll         , Gll^Fmf     , Gll         , Gll^Fmf     , Gs^Vl       , Gll         , Gll         , Gll         , Wwf         , Gll         , Gll         , Rb          , Rb          , Rb          , Gll         
Gll         , Cv          , Cv          , Gll         , Cv          , Gll^Fp      , Gll^Fp      , Gll         , Gll         , Gll         , Gll^Fp      , Gll^Fp      , Gll         , Gll         , Hh^Fds      , Gll         , Gs^Fds      , Gll         , Gs^Fds      , Gll         , Gs^Fms      , Gll         , Gll         , Gll         , Gll^Fp      , Gll^Fp      , Gll         , Gll         , Gll^Fmf     , Gll^Fmf     , Gll^Fmf     , Gll^Fmf     , Gll         , Gll^Fmf     , Gll^Fmf     , Gll^Fmf     , Gll^Fp      , Gll^Fp      , Gll^Fp      , Wwf         , Gll^Fp      , Rb          , Gll         , Gll^Fmf     , Gll         , Gll         
Gll         , Gll         , Gll         , Gll         , Gll         , Cv          , Gll         , Gll^Fp      , Gll^Fp      , Gll         , Gll^Fp      , Gll         , Gll         , Hh^Fds      , Hh^Fds      , Gs^Fms      , Gs^Fms      , Gs^Fms      , Gs^Fms      , Gs^Fms      , Gg          , Gs^Fms      , Gs^Fms      , Gll         , Gll         , Gll         , Gs^Fds      , Gs^Fds      , Gs^Fds      , Gll         , Gll         , Gll^Fmf     , Gll^Fmf     , Gll^Fmf     , Gll         , Gll         , Gll         , Gll         , Wwf         , Wwf         , Rb          , Rb          , Gll^Fmf     , Gll^Fmf     , Gll^Fmf     , Gll         
Gll         , Gll         , Gs          , Gll         , Gll         , Gll         , Gll         , Gll         , Gll^Fp      , Gll         , Gll         , Gll         , Gll         , Hh^Fds      , Gll^Fp      , Gs^Fms      , Gs^Fms      , Gs^Fms      , Gg          , Gs^Fms      , Gs^Fms      , Gs^Fms      , Gs^Fds      , Gll         , Gll         , Gll^Fp      , Gg          , Gs^Fds      , Gg          , Gs^Fds      , Cv          , Gll^Fp      , Cv          , Cv          , Wwf         , Wwf         , Wwf         , Wwf         , Rb          , Gs^Vh       , Gll^Fp      , Gll^Fmf     , Gll         , Gll^Fmf     , Gll^Fmf     , Gll         
Gll         , Gll         , Gs^Fms      , Gs          , Chs         , Gll         , Gll         , Cv          , Cv          , Gll^Fp      , Gll^Fp      , Gll         , Gg^Fet      , Hh^Fds      , Hh^Fds      , Gs^Fms      , Hh^Fds      , Gg          , Gs^Fms      , Gs^Fms      , Gs^Fms      , Gs^Fms      , Gs^Fms      , Gs^Vl       , Gs^Fms      , Gs^Fms      , Hh^Fds      , Gg          , Gll^Fp      , Cv          , Cv          , Cv          , Gll^Fp      , Gll^Fp      , Gll         , Gll^Fp      , Gll^Fp      , Rb          , Gg          , Gs^Fds      , Gll^Fp      , Gll^Fmf     , Gll^Fmf     , Gll^Fmf     , Gll^Fmf     , Gll         
Gll         , Gll         , Hh^Fms      , Gs^Fms      , Gll         , Gll         , Gll         , Gll         , Gll         , Gll         , Gll^Fp      , Gll         , Gs^Fms      , Gs^Fms      , Hh^Fds      , Gll         , Hh^Fds      , Hh^Fds      , Gs^Fms      , Gll         , Gs^Fms      , Gs^Fms      , Gll         , Gll         , Gll^Fp      , Gg          , Hh^Fds      , Gg          , Gg          , 2 Kv        , Cv          , Cv          , Gll         , Gll         , Gll^Fp      , Gll         , Gll^Fp      , Gg          , Gg          , Gg          , Rb          , Gll^Fp      , Gll^Fmf     , Gll^Fmf     , Gll^Fmf     , Gll         
Gll         , Gll         , Hh^Fms      , Gll         , Hh^Fms      , Gll         , Gs^Vl       , Gll         , Gll         , Gll         , Gll         , Gll^Fp      , Gs^Fms      , Gs^Fms      , Hh^Fds      , Gll         , Gll         , Gll         , Gll^Fp      , Gll         , Gll         , Gs^Fms      , Gs^Fms      , Gll         , Gs^Fms      , Hh^Fds      , Gs^Fms      , Gg          , Gll^Fp      , Gll^Fp      , Gll         , Gll         , Gll         , Gll         , Gs^Fds      , Gll^Fp      , Gll^Fp      , Rb          , Rb          , Rb          , Gll         , Gll^Fmf     , Gll^Fmf     , Gll^Fmf     , Gll^Fmf     , Gll         
Gll         , Gll         , Gll         , Hh^Fms      , Gs          , Hh^Fms      , Gll         , Wwf         , Gll         , Gll         , Chs         , Cv          , Cv          , Gll^Fp      , Gll^Fp      , Gll         , Gll         , Gs^Fms      , Gs^Fms      , Gll         , Gll^Fp      , Gll         , Gs^Fds      , Gs^Fms      , Gs^Fms      , Hh^Fds      , Gll         , Gll^Fp      , Gll         , Gll^Fp      , Gll^Fp      , Gll^Fp      , Gll         , Gll         , Gll^Fp      , Gll         , Gs^Fds      , Gg          , Rb          , Gll^Fmf     , Gll^Fmf     , Gll^Fmf     , Gll         , Gll         , Gll^Fp      , Gll         
Gll         , Gll         , Gll         , Gll         , Gll         , Gs          , Gs          , Wwf         , Cv          , Gll         , Gll         , Gll         , Gll         , Cv          , Gll         , Gll^Fp      , Gll^Fp      , Gs^Fms      , Gs^Fms      , Gs^Fms      , Gll^Fp      , Gs^Fds      , Gs^Vh       , Gg          , Hh^Fds      , Hh^Fds      , Gg^Fet      , Gll         , Wwf         , Wwf         , Gll^Fp      , Gll^Fmf     , Gll^Fmf     , Gs^Vl       , Gll         , Gll         , Gll         , Rb          , Gll         , Gll^Fmf     , Hh^Fds      , Gll         , Gll^Fp      , Gs^Vl       , Gll         , Gll         
Gll         , Gll         , Gs^Fms      , Gs^Fms      , Gll         , Gll         , Gs^Vh       , Gll         , Cv          , Gll         , Gll         , Gll         , Gll         , Gll         , Gs^Vh       , Gll         , Gll         , Gll^Fp      , Gs^Fms      , Gs^Fms      , Gg          , Hh^Fds      , Gll^Fp      , Gg          , Hh^Fds      , Gll^Fp      , Gll^Fp      , Gll         , Gll^Fp      , Wwf         , Gll^Fmf     , Gll         , Gll^Fmf     , Gll^Fmf     , Gll^Fmf     , Gll^Fmf     , Gll^Fp      , Gll         , Hh^Fds      , Hh^Fds      , Gll^Fp      , Gs^Fms      , Gs^Fms      , Gll         , Gll         , Gll         
Gll         , Gll         , Gll         , Gs^Fms      , Gll         , Gll         , Gll         , Gll         , Gll         , Gll         , Gll         , Gg          , Gg          , Gll         , Gg          , Gll         , Cv          , Gll^Fp      , Gs^Fms      , Gs^Fms      , Gs^Fms      , Gg          , Gs^Fms      , Hh^Fds      , Gll         , Gll         , Gll         , Gll^Fp      , Gll^Fp      , Gll^Fp      , Gll^Fmf     , Gll^Fmf     , Gll         , Gll^Fmf     , Rb          , Gll         , Gll         , Gll^Fp      , Hh^Fds      , Gg          , Gs^Fms      , Gs^Fms      , Gs^Fms      , Gll^Fmf     , Gll         , Gll         
Gll         , Gll         , 5 Kv        , Gs^Fms      , Gll         , Gll         , Gs^Fms      , Gll         , Gll         , Gll         , Gll         , Gll         , Gll         , Gg          , Gll         , Gll         , Gll         , Cv          , Gll^Fp      , Gll         , Cv          , Gs^Fms      , Gll         , Gll         , Gll^Fmf     , Gll         , Gll         , Gll^Fp      , Gll^Fp      , Gll^Fmf     , Gll^Fmf     , Gll         , Rb          , Gll         , Rb          , Rb          , Gll         , Hh^Fds      , Gg          , Gll^Fp      , Gll^Fmf     , Gll         , Gll         , Gll^Fmf     , Gll^Fmf     , Gll         
Gll         , Gll         , Cv          , Cv          , Gll         , Gll         , Gs^Fms      , Gll         , Gll         , Gll         , Gll         , Gll         , Gs^Fms      , Gs^Fms      , Gll         , Gll         , Gll         , Gll         , Gll         , Gll         , Gll         , Hh^Fds      , Gll         , Gll         , Gs^Fds      , Gll^Fmf     , Gll^Fmf     , Gll         , Gll         , Gll         , Gll^Fmf     , Rb          , Gll         , Rb          , Gll         , Gll         , Gll         , Gs^Fms      , Gg          , Gs^Fms      , Gll^Fp      , Gll^Fmf     , Gll^Fmf     , Gll^Fmf     , Gll         , Gll         
Gll         , Gll         , Gll         , Gll         , Gs^Vl       , Gll         , Gs^Fms      , Gll         , Gll         , Chs         , Gll         , Gll         , Gs^Fms      , Gll         , Gll         , Gll         , Gll^Fp      , Gll         , Gll^Fp      , Gll         , Gll         , Gll^Fp      , Gll         , Gll^Fp      , Gll^Fp      , Gll^Fmf     , Gll^Fmf     , Gll^Fmf     , Gs^Vl       , Gll         , Rb          , Rb          , Gll         , Gll         , Gll^Fmf     , Gll^Fp      , Gll         , Gs^Fms      , Gs^Fms      , Gs^Fms      , Gs^Fds      , Gll         , Gs^Fds      , Gs^Fds      , Gll         , Gll         
Gll         , Gll         , Gs          , Gll         , Gll         , Gll         , Gll         , Gll         , Gll         , Gll         , Gll         , Gs^Fms      , Gll         , Gll         , Gll         , Gs^Vl       , Gll         , Gll^Fp      , Gll^Fp      , Gll         , Gll         , Gg^Fet      , Gs^Fms      , Gll         , Gll         , Gll^Fmf     , Gll         , Gll         , Rb          , Rb          , Gll         , Gll^Fmf     , Gll^Fmf     , Gll^Fmf     , Gll         , Gll^Fp      , Gs^Fms      , Gs^Fms      , Gs^Fms      , Gs^Fds      , Gs^Fms      , Gs^Fms      , Gs^Fms      , Gs^Fds      , Gll         , Gll         
Gll         , Gll         , Gs          , Gll         , Gll         , Gll         , Gs^Fms      , Gs^Fms      , Qlf         , Gll         , Gll         , Gll         , Gll         , Hh^Fms      , Hh^Fms      , Hh^Fms      , Gll         , Gll         , Gll^Fp      , Gll         , Gll         , Gs^Fms      , Gll         , Gll         , Gll^Fmf     , Gll^Fmf     , Rb          , Rb          , Rb          , Gll         , Gll         , Gll^Fmf     , Gll^Fp      , Gll^Fp      , Gll         , Gs^Vh       , Gll         , Gs^Fms      , Gll^Fp      , Gs^Fms      , Gs^Fms      , Gs^Fms      , Gs^Fms      , Gll         , Gll         , Gll         
Gll         , Gs          , Gll         , Gs          , Gll         , Gs^Fms      , Gll         , Gll         , Gll         , Gll         , Gll         , Gg          , Gg          , Gg          , Gg          , Gll         , Gll         , Gll         , Gll^Fp      , Gll^Fp      , Gll^Fp      , Hh^Fds      , Hh^Fds      , Gll         , Rb          , Rb          , Rb          , Rb          , Gll^Fmf     , Gll^Fmf     , Gs^Fds      , Gll^Fp      , Gll         , Gll         , Wwf         , Gll         , Gll         , Gll^Fp      , Gll^Fp      , Gll^Fp      , Gs^Fms      , Gs^Fms      , Gs^Fms      , Gll^Fmf     , Gll^Fmf     , Gll         
Gs          , Gs          , Gs          , Gs          , Gll         , Gs^Fms      , Gll         , Gll         , Gll         , Gll         , Gll         , Gll         , Gll         , Gll         , Gll         , Gll         , Gll         , Gll         , Cv          , Gll^Fp      , Gll^Fp      , Gll         , Gll         , Gll         , Rb          , Gll         , Gll         , Gll^Fmf     , Gll^Fmf     , Gll^Fmf     , Gll         , Gll^Fp      , Gll^Fp      , Gll^Fp      , Wwf         , Gll^Fmf     , Gll         , Gll^Fp      , Gg          , Gs^Fms      , Gg          , Gll^Fp      , Gll         , Gll         , Gll         , Gll^Fmf     
Gll         , Gs          , Gll         , Gll         , Gll         , Gll         , Qlf         , Gll         , Gll         , Gs^Fms      , Gs^Fms      , Gll         , Gll         , Gll         , Chs         , Gll         , Gll         , Gll         , Gll         , Cv          , Cv          , Gll         , Rb          , Rb          , Gll^Fp      , Gll         , Gll^Fmf     , Gll^Fmf     , Gll^Fmf     , Hh^Fds      , Gll         , Gll         , Gll         , Gll^Fp      , Gll^Fp      , Gll^Fmf     , Gll^Fmf     , Gll^Fp      , Gs^Fms      , Gs^Fms      , Gll^Fp      , Gs^Fds      , Gll         , Gll         , Gll^Fmf     , Gll^Fmf     
Gll         , Gll         , Gll         , Gll         , Gll         , Gll         , Qlf         , Qlf         , Gll         , Gll         , Gs^Fms      , Gs^Fms      , Gll         , Gll         , Gll         , Gll         , Chs         , Chs         , Gll         , Gll         , Gll         , Kv^Cov      , Rb          , Gg          , Gll^Fp      , Gll         , Gll         , Gll^Fmf     , Gll         , Hh^Fds      , Gll^Fp      , Gll^Fp      , Gll         , Gll^Fp      , Gll         , Gll^Fmf     , Gll^Fmf     , Gll         , Gs^Fms      , Gs^Fms      , Gs^Fms      , Gs^Fms      , Gs^Fms      , Gs^Fms      , Gll^Fmf     , Gll^Fmf     
Gll         , Gll         , Qlf         , Qlf         , Qlf         , Gll         , Gll         , Gll         , Gll         , Gll         , Gll         , Gll         , Gll         , Wwf         , Gll         , Wwf         , Gll         , Gll         , Gll         , Gll         , Rb          , Rb          , Kv^Cov      , Gll^Fp      , Gll^Fp      , Gll^Fp      , Gll         , Gll^Fmf     , Gll         , Hh^Fds      , Gs^Fds      , Gll         , Gll         , Gll         , Gll         , Gll^Fmf     , Gll^Fmf     , Gll^Fmf     , Gs^Fms      , Gs^Fms      , Gs^Fms      , Gll         , Gll         , Gs^Fms      , Gll^Fmf     , Gll^Fmf     
Gll         , Gll         , Gll         , Qlf         , Gs^Vl       , Qlf         , Gll         , Gll         , Gll         , Hh          , Gll         , Hh          , Hh          , Gll         , Gll         , Gll         , Gs^Vl       , Gll         , Rb          , Rb          , Gll         , Gll         , Gll         , Cv          , Cv          , Gll^Fp      , Gll^Fp      , Gll         , Gs^Fms      , Gs^Fms      , Gg          , Gll^Fp      , Gll^Fp      , Gll^Fp      , Gll^Fp      , Gll^Fmf     , Gll^Fmf     , Gll^Fmf     , Gll         , Gs^Fms      , Gs^Vh       , Gll         , Gs^Fms      , Gll^Fmf     , Gll^Fmf     , Gll         
Gll         , Gll         , Gll         , Gll         , Gll         , Gll         , Gll         , Gll         , Gll         , Gll^Wm      , Gll         , Gll         , Gll         , Gll         , Rb          , Gll         , Gg          , Gll         , Gll         , Gll         , Gll         , Gll         , Gs^Vh       , Gll         , Gll         , Cv          , Qlf         , Gll^Fp      , Gs^Fms      , Gs^Fms      , Gs^Fms      , Gg          , Gll^Fp      , Gll         , Gll         , Gll         , Gll         , Gs^Fds      , Gs^Fds      , Gll         , Gs^Fms      , Gs^Fms      , Gs^Fms      , Gll         , Gll         , Gll         
Gll         , Gll         , Gll         , Gll         , Gll         , Gll         , Gs^Fms      , Gll         , Gs^Fms      , Gll         , Gll         , Gll         , Rb          , Rb          , Rb          , Rb          , Gg          , Gll         , Gll         , Gll         , Gll         , Gll         , Gll         , Gll         , Gll         , Qlf         , Qlf         , Qlf         , Gll^Fp      , Gll^Fp      , Gll^Fp      , Gll^Fp      , Gs^Fms      , Gll         , Wwf         , Gs^Vl       , Gs^Fds      , Gll^Fp      , Gll         , Gll         , Gs^Fms      , Gs^Fms      , Gll         , Gll         , Gll^Fmf     , Gll         
Gll         , Gll         , Gs          , Gs          , Qlf         , Qlf         , Gll         , Gll         , Gs^Fms      , Gll         , Gs^Fms      , Gll         , Gll         , Rb          , Gll         , Gll         , Gll^Fp      , Gll         , Gll         , Gll^Fp      , Gll^Fp      , Gll         , Gll         , Gll         , Gll         , Gll         , Gll         , Gll         , Cv          , Gll^Fp      , Gll         , Gg^Fet      , Gll         , Gs^Fms      , Wwf         , Hh^Fds      , Hh^Fds      , Hh^Fds      , Gs^Fms      , Gll         , Gs^Fms      , Gll^Fp      , Gll^Fp      , Gll         , Gll^Fmf     , Gll^Fmf     
Gll         , Gll         , Gll         , Gs          , Gll         , Qlf         , Gs^Vl       , Gll         , Gs^Fms      , Gs^Fms      , Gs^Fms      , Gll         , Rb          , Gll         , Gll^Fmf     , Gll         , Gg          , Gll         , Gll         , Gll         , Gll         , Gll^Fp      , Gll         , Gll         , Gll         , Gll         , Gll         , Gll         , Gll         , Gll         , Qlf         , Qlf         , Cv          , Gll^Fp      , Gll^Fp      , Gll         , Hh^Fms      , Gll         , Gll         , Gll         , Hh^Fds      , Gg          , Gll^Fp      , Gll         , Gll^Fmf     , Gll^Fmf     
Gll         , Gs          , Gll         , Gll         , Gs^Fms      , Gll         , Gll         , Gll         , Gll         , Gs^Fms      , Wwf         , Rb          , Gg          , Gll^Fmf     , Gg          , Gll^Fmf     , Gll^Fmf     , Gll         , Gll         , Gll         , Gg          , Gll^Fp      , Gll         , Gll^Fp      , Gll^Fp      , Gll         , Gll         , Gll         , Chs         , Gll         , Gll         , Qlf         , Cv          , Gll         , Gll         , Gll         , Gll         , Hh^Fms      , Gll         , Gll         , Gll         , Gs^Fms      , Gll^Fp      , Gll         , Gll^Fmf     , Gll         
Gll         , Gs          , Gll         , Gll         , Gll         , Gll         , Gll         , Gll         , Gll         , Wwf         , Wwf         , Rb          , Gll         , Gll         , Gll^Fmf     , Gg          , Gll         , Gll^Fmf     , Gs^Vh       , Gg          , Mv          , Gg          , Gll         , Gll         , Gll         , Gll^Fp      , Gll^Fp      , Gll         , Gll         , Chs         , Gll         , Gll         , Gll         , Gll         , Qlf         , Gll^Fp      , Gll^Fp      , Hh^Fms      , Gll         , Gs^Fms      , Gs^Fms      , Gs^Fms      , Gll^Fp      , Gll         , Gll^Fmf     , Gll         
Gll         , Gs          , Gll         , Qlf         , Gll         , Qlf         , Qlf         , Qlf         , Gll         , Gll         , Gll         , Rb          , Gll         , Gll         , Gll         , Gll         , Gll         , Gll         , Gll         , Gll         , Gll         , Gg          , Gll         , Gll         , Gll         , Gll^Fp      , Gll         , Gll         , Gll         , Gll         , Gll         , Qlf         , Gll         , Gll         , Gll         , Qlf         , Qlf         , Gll^Fp      , Gll^Fp      , Gs^Fms      , Gs^Fms      , Gg          , Gll^Fp      , Gll         , Gll         , Gll         
Gll         , Gs          , Gll         , Gll         , Gs^Fms      , Gll         , Gll         , Gll         , Gg^Dr       , Hh          , Hh          , Hh          , Hh          , Gll         , Gll         , Gll         , Gll         , Qlf         , Gs^Fms      , Gll         , Gll         , Gll         , Gll         , Hh^Fms      , Gll         , Gll         , Gll         , Gll         , Gll         , Gll         , Qlf         , Qlf         , Gll         , Gll         , Gll^Fp      , Gll         , Gll         , Cv          , Gll^Fp      , Gs^Fms      , Gs^Fms      , Gg          , Gll^Fp      , Gll         , Gll^Fp      , Gll         
Gll         , Gs          , Gs          , Gll         , Gll         , Gll         , Gs^Fms      , Gll         , Gll         , Gll         , Gll         , Gll         , Gll^Fp      , Gll         , Gll         , Qlf         , Qlf         , Gs^Fms      , Gll         , Gll         , Gll         , Gg          , Gg          , Hh^Fms      , Gll         , Gll         , Gll         , Gll         , Qlf         , Gll         , Gll         , Gll^Fp      , Gll^Fp      , Gll^Fp      , Gll^Fp      , Gll         , Gg^Fet      , Cv          , Cv          , Gs^Fms      , Gll^Fp      , Gs^Vl       , Gll^Fp      , Gll^Fp      , Gll^Fp      , Gll^Fp      
Gs          , Gs          , Gs          , Gll         , Gll         , Gs^Fms      , Gll         , Gll         , Gll         , Rb^Wm       , Rb          , Rb          , Gll^Fp      , Gll         , Gll         , Gll         , Hh          , Gll         , Gll         , Gll         , Gll         , Gll^Fmf     , Gll^Fmf     , Gll         , Gll         , Hh          , Hh          , Gll         , Gll         , Gll         , Wwf         , Gll         , Gll         , Gll         , Gll         , Gll         , Gll         , Gll         , Gll         , Gs^Fms      , Gll^Fp      , Gll^Fp      , Cv          , Gll         , Gll^Fp      , Gll^Fp      
Gll         , Gs          , Gll         , Qlf         , Qlf         , Gll         , Gll         , Gll         , Gg^Dr       , Gll         , Rb          , Gll         , Gs          , Gll         , Gll         , Hh          , Gll         , Hh          , Hh          , Gll         , Gll         , Gll^Fmf     , Gg          , Gg          , Gll         , Gll         , Gs^Fms      , Gll         , Gll         , Gll         , Wwf         , Hh^Fms      , Hh^Fms      , Gll         , Gll         , Gs^Vh       , Gll         , Gll         , Gll         , Chs         , Chs         , Gg          , Cv          , Gll         , Gll^Fp      , Gll^Fp      
Gll         , Gll         , Gll         , Gll         , Gll         , Qlf         , Gll         , Gll         , Gll         , Rb          , Gll         , Gs          , Gll^Fp      , Gll         , Hh          , Gll         , Gll         , Gll         , Gll         , Gll         , Gll         , Gll         , Gg          , Gll         , Gll         , Gs^Fms      , Gll         , Gll         , Gll         , Gg^Dr       , Wwf         , Hh^Fms      , Hh^Fms      , Hh^Fms      , Gll         , Qlf         , Qlf         , Gll         , Gll         , Gll         , Gll         , Qlf         , Qlf         , Gll         , Gll^Fp      , Gll^Fp      
Gll         , Gll         , Qlf         , Gll         , Qlf         , Gll         , Qlf         , Gll         , Rb          , Rb          , Gll         , Gs          , Gll^Fp      , Hh          , Qlf         , Qlf         , Qlf         , Gll         , Gll         , Gd^Fdf      , Gll         , Gll         , Wwf         , Gll         , Gll         , Gs^Fms      , Gll         , Gll         , Gll         , Gll         , Gll         , Gll         , Gll         , Gll         , Gll^Fmf     , Gll         , Gll         , Qlf         , Gll         , Gll         , Gll         , Gll         , Gll         , Gll         , Gll         , Gll         
Gll         , Gll         , Gll         , Gll         , Gll         , Gll         , Gll         , Gll         , Rb          , Gll^Fp      , Gll^Fp      , Gll^Fp      , Gll         , Hh          , Gll         , Gll         , Gll         , Gll         , Gll         , Gd^Fdf      , Gd^Fdf      , Gll         , Wwf         , Wwf         , Gll         , Gll         , Gll^Fmf     , Gll^Fmf     , Gll^Fmf     , Gll^Fmf     , Gll         , Gll         , Gll^Fmf     , Gll^Fmf     , Gll         , Gll         , Gll         , Gll         , Gll         , Gll         , Gll         , Qlf         , Gll         , Cv          , Cv          , Gll         
Gll         , Gll^Fp      , Gll^Fp      , Gll         , Gll^Fp      , Gg^Dr       , Wwf         , Wwf         , Rb          , Gll         , Gs^Vl       , Gll         , Gll         , Gll         , Gll         , Gs^Fms      , Gs^Fms      , Gll         , Gs^Fms      , Gll         , Gd^Fdf      , Gll         , Gll         , Wwf         , Wwf         , Gll         , Gll         , Gll^Fmf     , Gll^Fmf     , Gll^Fmf     , Gll         , Gll         , Gll         , Gll         , Gll         , Gll         , Gll         , Gs^Vl       , Gll         , Gll         , Qlf         , Gll         , Gll         , Gll         , Gll         , Cv          
Gll         , Gll         , Gll         , Gll^Fp      , Gs^Fms      , Gll         , Gll         , Gll         , Rb          , Gll         , Gll         , Gs          , Gs          , Gll         , Gs^Vl       , Gll         , Gll         , Gll         , Gll         , Gs^Fms      , Gll         , Gll         , Gll^Fmf     , Gll         , Wwf         , Wwf         , Gll^Fmf     , Gll^Fmf     , Gll         , Gll         , Qlf         , Gll         , Qlf         , Gll         , Gll         , Gll         , Gll         , Gll         , Gll         , Qlf         , Gll         , Gll         , Gll         , Cv          , Cv          , Gll         
Gll         , Gll         , Gll         , Gs^Fms      , Gll         , Gll         , Ce          , Gll         , Gll         , Rb          , Rb          , Gll         , Gg          , Gll         , Gll         , Gll         , Gg          , Gg          , Gll         , Gll         , Gll         , Gll         , Gll         , Gll         , Gll         , Gll         , Gll         , Gll         , Gll         , Gll         , Gll         , Qlf         , Qlf         , Gll         , Gs^Fms      , Gs^Fms      , Gll         , Gll         , Gs^Fms      , Gll         , Gll         , Gll         , Gs^Vh       , 4 Kv        , Gll         , Gll         
Gll         , Gs^Vh       , Gll         , Gll         , Ce          , Ce          , 1 Ke        , Gll         , Rb          , Gll         , Hh          , Gg          , Hh          , Hh          , Gs^Fms      , Gll         , Gll         , Gg^Wm       , Gll         , Gll         , Gg^Dr       , Gll         , Gll         , Gll         , Gll         , Gd^Fetd     , Gll         , Wwf         , Gll         , Gll         , Gll         , Gll         , Gll         , Gll         , Gll         , Gll         , Gll         , Gll         , Gll         , Gll         , Gll^Fmf     , Gs^Vh       , Gll^Fmf     , Gll         , Gll         , Gll         
Gll         , Gll         , Gll         , Gs^Fms      , Ce          , Gg          , Ce          , Ce          , Rb          , Gll^Fp      , Gll^Fp      , Hh          , Ce          , Ce          , Ce          , Gs^Fms      , Gs^Fms      , Gll         , Gs^Fms      , Gll         , Gll         , Gll         , Gs^Fms      , Gs^Fms      , Gll         , Gll         , Gll         , Gll         , Gg^Dr       , Gll         , Gll         , Gll^Fmf     , Gll         , Gll         , Gll         , Qlf         , Qlf         , Gll         , Gll         , Gll         , Gll^Fmf     , Gll         , Gll^Fmf     , Gll         , Gll^Fmf     , Gll^Fmf     
Gll         , Gll         , Qlf         , Gll         , Gll         , Ce          , Gll         , Rb          , Gs^Vl       , Gll         , Gll^Fp      , 6 Ke        , Ce          , Qlf         , Ce          , Gll         , Gll         , Gs^Fms      , Gll         , Gll         , Gll         , Gll         , Gll         , Gll         , Qlf         , Gll         , Gll         , Gll         , Qlf         , Gs^Vh       , Gll         , Gll         , Gll^Fmf     , Gll         , Gll         , Gll         , Gll         , Gll         , Gll         , Gll         , Gs^Fms      , Gll^Fmf     , Gll^Fmf     , Gll^Fmf     , Gll^Fmf     , Gll^Fmf     
Gll         , Gll         , Qlf         , Gll         , Gll         , Gll         , Gll         , Rb          , Gll         , Gg^Dr       , Gll         , Gll^Fp      , Qlf         , Qlf         , Gll         , Gll         , Gs^Vh       , Gll         , Gll         , Gs^Vl       , Gll         , Gll         , Qlf         , Qlf         , Qlf         , Qlf         , Qlf         , Gll         , Qlf         , Gll         , Qlf         , Gll         , Gll         , Gll         , Gll         , Gll         , Gll^Fmf     , Gll         , Gs^Fms      , Gs^Fms      , Gs^Vh       , Gll         , Gll         , Gll^Fmf     , Gll^Fmf     , Gll^Fmf     
Gll         , Gll         , Gll         , Gll         , Qlf         , Gll         , Qlf         , Gll         , Qlf         , Qlf         , Gll         , Gs^Fms      , Gll         , Gll         , Gll         , Gs^Fms      , Gll         , Gll         , Gs^Fms      , Gll         , Gs^Fms      , Gll         , Gll         , Chs         , Chs         , Chs         , Chs         , Qlf         , Qlf         , Qlf         , Gll         , Gll         , Gs^Vl       , Gll         , Gll^Fmf     , Gll^Fmf     , Gll^Fmf     , Gll         , Gll         , Gll         , Qlf         , Qlf         , Ql          , Gll         , Gll^Fmf     , Gll^Fmf     
Gll         , Gll         , Qlf         , Rb          , Qlf         , Rb          , Gll         , Gll         , Wwf         , Gll         , Gll         , Gll         , Gll         , Gs^Fms      , Gll         , Gll         , Gll         , Gll         , Gll         , Gll         , Gll         , Gll         , Gll         , Gll         , Gll         , Gll         , 3 Khs       , Chs         , Gll         , Gll         , Gll         , Gll         , Gll^Fmf     , Gll^Fmf     , Gll^Fmf     , Gll         , Gll^Fmf     , Gll^Fmf     , Gll^Fmf     , Gll         , Gll         , Qlf         , Gll         , Gll         , Gll^Fmf     , Gll^Fmf     
Gll         , Rb          , Rb          , Qlf         , Gll         , Gll         , Gll         , Wwf         , Wwf         , Wwf         , Wwf         , Gll         , Gll         , Gll         , Gll         , Qlf         , Gll         , Gll         , Gll         , Gll         , Gll         , Gll         , Gll         , Gll         , Gll         , Gll         , Gll         , Gll         , Gll         , Gll         , Gll         , Gll         , Gll^Fmf     , Gll^Fmf     , Gll         , Gll^Fmf     , Gll         , Gll         , Gll^Fmf     , Gll         , Gll         , Gll         , Gll         , Gll         , Gll^Fmf     , Gll         
