border_size=1
usage=map

Gs^Fms      , Gs          , Ggf         , Gg          , Gg          , Gg          , Gg          , Ww          , Ww          , Ww          , Ww          , Gs^Fp       , Gs^Fds      , Gs^Fp       , Gg          , Gs^Fp       , Ggf         , Gs^Fp       , Gs^Fds      , Gs^Fp       , Gs^Fds      , Gs^Fp       , Gs          , Gs^Fp       , Gg          , Gs^Fp       , Gg          , Gg          , Gg          , Rp          , Rp          , Gs^Fms      , Rp          , Gs^Fms      , Rp          , Rp          , Rp          
Gg^Ve       , Gs          , Gs          , Gg          , Ggf         , Gs^Fp       , Gs^Fds      , Gs^Fds      , Ww          , Ww          , Ww          , Ww          , Gs^Fp       , Gs^Fms      , Gs^Fms      , Hh^Fms      , Hh^Fms      , Gs^Fms      , Gs^Fms      , Gs^Fms      , Gs^Fms      , Gs^Fp       , Gs^Fms      , Gg^Ve       , Gs^Fms      , Gs^Fp       , Gs^Fms      , Rp          , Rp          , Gs^Vht      , Rd          , Gs^Fms      , Gg^Ve       , Gs^Fms      , Gs^Fms      , Gs^Fms      , Gs^Fms      
Gs          , Gs          , Rd          , Rd          , Gs          , Gs^Fp       , Gs^Fds      , Gs^Fds      , Ww          , Ww          , Ww          , Ww          , Ww          , Gs^Fds      , Gs^Fms      , Hh^Fds      , Hh^Fms      , Gs^Vht      , Gs^Fms      , Gg^Fet      , Gs^Fms      , Gs^Fms      , Gs^Fms      , Rd          , Gs^Fms      , Rp          , Rp          , Gs^Fms      , Rd          , Rd          , 3 Rd        , Gs^Fp       , Gs^Fms      , Gs^Fms      , Gs^Fp       , Hh^Fp       , Gs^Fms      
Gs^Fds      , Gg          , Gg          , Rd          , Gs          , Gs^Fds      , Gs^Fds      , Hh          , Gs^Fds      , Ww          , Ww          , Wo          , Wo          , Wwr         , Ww          , Hh^Fms      , Hh          , Gs^Fp       , Gs          , Ggf         , Gs^Fms      , Gs^Fms      , Gs^Fds      , Gs^Fms      , Gs^Vht      , Rp          , Gg          , Gs^Fms      , Gg^Ve       , Rd          , Gs^Fp       , Gs^Fp       , Gs^Fds      , Gs^Fms      , Gs^Fms      , Gs^Fms      , Gs^Fms      
Gs^Fds      , Gs^Fds      , Gg          , Gs^Fds      , Rd          , Gs^Fds      , Gs^Fms      , Gs^Fp       , Gs^Fds      , Ww          , Ww          , Wo          , Wo          , Wo          , Ww          , Ww          , Gs^Fds      , Gs^Fms      , Gg^Ve       , Rd          , Gg^Ve       , Ww          , Gs^Fms      , Rp          , Rp          , Gs^Fms      , Gs^Fds      , Gs^Fms      , Ggf         , Gs^Fp       , Rd          , Gg^Ve       , Gs^Fms      , Gs^Fms      , Gg^Ve       , Gs^Fms      , Gs^Fms      
Gs^Fms      , Gs^Fds      , Gs^Fds      , Gs^Fds      , Rd          , Gs^Fds      , Gs^Fds      , Gs^Fds      , Gs^Fmf      , Hh^Fds      , Ww          , Ww          , Wo          , Wo          , Wo          , Wwr         , Gs^Fms      , Gs^Fms      , Gs^Fp       , Gs^Fp       , Rd          , Ww          , Rp          , Gs          , Gs          , Gs^Fms      , Gs^Fms      , Hh^Fms      , Gs^Fms      , Gs^Fds      , Gs^Fms      , Gs^Fms      , Gs          , Rd          , Gs          , Gs^Fp       , Gs^Fms      
Gs^Fds      , Gs^Fds      , Gs^Fds      , Gs^Fms      , Rd          , Rd          , Gs^Fds      , Gs^Fds      , Gs^Fmf      , Gs^Fmf      , Hh^Fp       , Ww          , Ww          , Wo          , Wo          , Wo          , Ww          , Gs^Fms      , Gs^Fp       , Gs^Fms      , Ww          , Ww          , Gs^Bw|      , Cv          , Ww          , Gs^Fms      , Gs^Fp       , Gs^Fp       , Ss          , Gs^Fms      , Gs^Fms      , Gs          , Rd          , Gg^Fet      , Rd          , Gs^Fds      , Gs^Fms      
Gs^Fds      , Gg          , Gs^Fds      , Rd          , Rd          , Gs^Fds      , Gg^Ve       , Hh          , Gs^Fmw      , 4 Hh^Fp     , Gs^Fmf      , Ss          , Ww          , Ww          , Wo          , Wo          , Wo          , Ww          , Ww          , Ww          , Ww          , Ww          , Ww^Bw|      , Ww          , Ww          , Ww          , Gs^Fms      , Gs^Fms      , Hh^Fms      , Gs^Fms      , Gg^Ve       , Gs          , Rd          , Re^Gvs      , Re^Gvs      , Gs^Fms      , Gs^Fms      
Gs^Fds      , Rd          , Rd          , Gs^Fds      , Gs^Fds      , Gs^Fds      , Gs^Fds      , Gs^Fdw      , Hh^Fp       , Hh^Fp       , Hh^Fms      , Gs^Fds      , Gs^Fds      , Ww          , Ww          , Wo          , Wo          , Wo          , Ww          , Ww          , Ww          , Cv          , Cv          , Cv          , Ww          , Ww          , Ww          , Gs^Fds      , Gs^Fms      , Gs^Fp       , Ggf         , Gs^Fms      , Gs^Fms      , Gs^Fp       , Gs^Uf       , Gs^Fp       , Gs^Fms      
Gs^Fds      , Rd          , Gs^Fp       , Gs^Fds      , Gs^Fds      , Gs^Fms      , Gs^Fds      , Gs^Fds      , Gs^Fds      , Gs^Fds      , Gs^Fds      , Gs^Fds      , Gs^Fds      , Gs^Fds      , Ww          , Ww          , Wo          , Wo          , Ww          , Ww          , Cv          , Cv          , Ce          , Cv          , Cv          , Ww          , Ww          , Ww          , Gs^Fms      , Gs^Fms      , Gs^Fms      , Gs          , Gs^Fms      , Rd          , Gs          , Gs^Fms      , Gs^Fms      
Gs^Fds      , Rd          , Hh^Fp       , Hh^Fms      , Hh^Fds      , Gs^Fds      , Gs^Fp       , Gs^Fp       , Gs^Fds      , Gs          , Gs          , Gs          , Gg^Ve       , Re^Gvs      , Gs^Fds      , Ww          , Ww          , Ww          , Ww          , Cv          , Cv          , Rp          , Ce          , Rp          , Cv          , Cv          , Ww          , Ww          , Ww          , Gs^Fms      , Gs^Fms      , Gs^Fms      , Gs^Fds      , Gs^Fms      , Gg^Ve       , Gs^Fms      , Gs^Fms      
Gs^Fds      , Rd          , Gs^Fp       , Gs^Fds      , Hh^Fms      , Gs^Fds      , Gs^Fp       , Gs^Fds      , Gs^Fds      , Gs          , Gg^Fet      , Gs^Uf       , Re^Gvs      , Re^Gvs      , Gs          , Ww          , Ww          , Ww          , Ww          , Cv          , Cv          , Rp          , 2 Kv        , Rp          , Cv          , Cv          , Ww          , Ww          , Ww          , Ww          , Gs^Fms      , Ss          , Gs^Fp       , Rd          , Ggf         , Gs^Fms      , Gs^Fms      
Ggf         , Gg          , Rd          , Gs^Fds      , Hh          , Gs^Fms      , Gs^Fds      , Gs^Fds      , Gg^Ve       , Ggf         , Gs^Uf       , Ss          , Gs^Vht      , Gs^Fds      , Gs          , Ww          , Ww          , Ww          , Cv          , Cv          , Rd          , Rp          , Gg^Fet      , Rp          , Rd          , Cv          , Cv          , Ww          , Ww          , Ww          , Gs^Fms      , Gs^Fp       , Rd          , Gs^Fms      , Gs^Fds      , Gs^Fms      , Gs^Fms      
Gs^Fds      , Gs^Fds      , Rd          , Gs^Fp       , Hh^Fds      , Hh^Fds      , Hh          , Gs^Fds      , Ggf         , Gs^Fds      , Ss          , Ss          , Gs^Fds      , Gs^Fds      , Gs^Fds      , Gs^Fds      , Ww          , Ww          , Cv          , Cv          , Kv          , Ce          , Rp          , Ce          , Kv          , Cv          , Cv          , Ww          , Ww          , Gs^Fms      , Gs^Fms      , Gs^Fms      , Gg^Ve       , Gs          , Gs^Fms      , Gs^Fp       , Gs^Fms      
Gs          , Gg          , Rd          , Gs^Fds      , Gs^Fds      , Gs^Fds      , Gs^Fds      , Hh^Fp       , Gs^Fms      , Gs^Fds      , Gs^Fds      , Gs^Fds      , Gs^Fds      , Gs^Fms      , Gs^Fds      , Gs^Fds      , Ww          , Ww          , Cv          , Ww          , Ww          , Cv          , Rp          , Cv          , Ww          , Wwr         , Cv          , Ww          , Ww          , Gs^Fds      , Hh^Fds      , Gs^Fp       , Gs^Fms      , Gs          , Gs^Fp       , Gs^Fms      , Gs^Fms      
Gs^Fds      , Gs          , Rd          , Gs^Fds      , Gs^Fds      , Hh          , Hh^Fms      , Re^Gvs      , Gs^Fds      , Gs^Fp       , Gs^Fms      , Gs^Fds      , Gs^Fds      , Mm          , Gs^Fds      , Gs^Fds      , Ww          , Ww          , Ww          , Cv          , Cv          , Cv          , Rp          , Cv          , Cv          , Cv          , Ww          , Wo          , Ww          , Gs^Fds      , Gs^Fms      , Gs^Fms      , Gs^Fms      , Gs^Vht      , Gs          , Gg^Ve       , Gs^Fms      
Gs^Fms      , Rd          , Rd          , Gs^Fds      , Gs^Fds      , Gs^Fds      , Hh^Fp       , Gg^Ve       , Gs^Uf       , Gs^Fp       , Gs^Fds      , Gs^Fds      , Gs^Fms      , Gs^Fds      , Gs^Fds      , Gs^Fds      , Gs^Fds      , Ww          , Ww          , Ww          , Cv          , Ww          , Rp          , Ww          , Cv          , Ww          , Wo          , Wo          , Wo          , Wo          , Ww          , Ww          , Ww          , Gs^Fms      , Gs^Fms      , Gs^Fms      , Gs^Fms      
Gs^Fds      , Rd          , Ggf         , Gs^Fms      , Gs^Fds      , Gs^Fds      , Re^Gvs      , Re^Gvs      , Ggf         , Ggf         , Gs          , Gs          , Gs^Fds      , Gs^Fds      , Gs^Fds      , Hh          , Gs^Fds      , Ww          , Ww          , Ww          , Cv          , Ww          , Cv          , Ww          , Cv          , Ww          , Wo          , Wo          , Wo          , Wo          , Wo          , Ww          , Wo          , Ww          , Ww          , Gs^Fms      , Gs^Fms      
Gs^Fds      , Gs^Fds      , Rd          , Gs^Fds      , Gs^Fp       , Gs^Fms      , Gs^Fds      , Gs^Fms      , Gs^Fds      , Ggf         , 5 Gs        , Gs          , Gs          , Gs^Vht      , Gs^Fds      , Gs^Fds      , Gs^Fds      , Gs^Fp       , Gs^Fds      , Ww          , Ww          , Cv          , Ww^Bw|      , Cv          , Ww          , Ww          , Ww          , Wo          , Wo          , Wo          , Wo          , Wo          , Wo          , Wo          , Wo          , Ww          , Ww          
Gs^Fds      , Gg          , Rd          , Gs^Fms      , Gs^Fds      , Gs^Fp       , Hh          , Gs^Fds      , Hh          , Hh          , Ss          , Ss          , Gs^Fp       , Gs^Fds      , Gs^Fds      , Gs^Fms      , Hh          , Gs^Fds      , Gs^Fp       , Gs^Fds      , Gs^Fds      , Gs^Fds      , Ww^Bw|      , Gs^Fds      , Gs^Fds      , Ww          , Gs^Fds      , Wwf         , Ww          , Wo          , Wo          , Wo          , Wo          , Wo          , Wo          , Wo          , Ww          
Gs^Fds      , Gs^Fds      , Rd          , Gs^Fds      , Gs^Fds      , Gs^Fds      , Gs^Fp       , Hh^Fds      , Hh^Fds      , Gs^Fds      , Gs^Fds      , Ss          , Gs^Fds      , Hh          , Gs^Fms      , Gs^Fp       , Gs^Fds      , Re^Gvs      , Re^Gvs      , Gs^Fds      , Gs^Fds      , Cv          , Rp          , Gg          , Hh^Fds      , Gs^Fds      , Gs^Fds      , Wwf         , Mm          , Ww          , Ww          , Ww          , Ww          , Wo          , Wo          , Ww          , Wo          
Ss          , Rd          , Rd          , Gs^Fds      , Hh          , Hh^Fds      , Gs^Fds      , Hh^Fds      , Gs^Fms      , Gs^Uf       , Ss          , Ss          , Gs^Fds      , Gs^Fds      , Gs^Fms      , Gs^Fms      , Gs^Fds      , Gs^Fds      , Gg^Ve       , Gs^Fds      , Rr          , Rp          , Rp          , Gg          , Gs^Fds      , Gs^Fds      , Wwf         , Hh^Fds      , Gs^Fds      , Gs^Fds      , Gs^Fds      , Gs^Fds      , Gs^Fds      , Ww          , Ww          , Ww          , Gs^Fds      
Ss^Bw/      , Ss^Bw|      , Ss          , Ss          , Ss          , Hh^Fds      , Hh^Fds      , Gs^Fds      , Gs^Fds      , Gs^Fds      , Gs^Fds      , Gs^Vht      , Gs          , Gs^Fdw      , Gs^Fdw      , Gs^Fds      , Gs^Fds      , Gs^Fds      , Rr          , Rp          , Rr          , Rr          , Gs          , Gs^Fds      , Ggf         , Gs^Fds      , Wwf         , Hh^Fms      , Gs^Fds      , Gs^Fp       , Hh^Fds      , Hh^Fds      , Gs^Fds      , Hh^Fds      , Gs^Fds      , Gs          , Gs^Fds      
Ss          , Rd          , Ss          , Gs^Fds      , Gs^Fds      , Gs^Fms      , Gs^Fds      , Gs^Fds      , Gs^Fds      , Hh          , Ggf         , Ggf         , Gs^Fds      , Gs^Fds      , Gs^Fdw      , Gs^Fds      , Rr          , Rp          , Rr          , Rp          , Gg          , Gs^Fds      , Gs^Vht      , Gs^Fds      , Gs^Fds      , Hh^Fds      , Wwf         , Gs^Fds      , Gs^Fds      , Hh^Fds      , 6 Hh^Fds    , Hh^Fds      , Hh^Fp       , Hh^Fds      , Gs          , Gs^Fms      , Gs^Fms      
Gs^Fds      , Rd          , Gs          , Gs^Fds      , Gs^Fds      , Gs^Fdw      , Gs^Fds      , Gs^Fms      , Gs^Fds      , Gs^Fds      , Gs^Fms      , Gs^Fds      , Gs^Fds      , Gs^Fds      , Gs^Fds      , Rp          , Rp          , Rr          , Rp          , Gs^Fds      , Gs^Fds      , Gs^Fds      , Gs^Fds      , Wwf         , Hh^Fds      , Wwf         , Wwf         , Hh^Fms      , Gs^Vht      , Hh^Fds      , Hh^Fds      , Hh^Fp       , Mm          , Gs^Fds      , Gs          , Gs^Fds      , Gs^Fms      
Gs^Fds      , Ggf         , Rd          , Gs^Fds      , Gs^Fdw      , Gs^Fms      , Gs^Fds      , Gs^Fds      , Gs^Fds      , Rd          , Gs^Fms      , Rd          , Rd          , Rd          , Gs^Fds      , Rp          , Gs^Fds      , Gs^Fms      , Gs^Fds      , Hh^Fds      , Gs^Fds      , Wwf         , Wwf         , Hh^Fms      , Wwf         , Gs^Fds      , Gs^Fds      , Gs^Fds      , Gs          , Gs^Fp       , Gs^Fds      , Mm          , Gs^Fds      , Gs^Fds      , Gs          , Gs^Fds      , Gs^Fds      
Gs^Fds      , Re          , Rd          , Gs          , Gs^Fds      , Gs^Fds      , Gs^Fds      , Gs^Fds      , Rd          , Gs^Fds      , Rd          , Gs^Fds      , Gg^Ve       , Gs^Fds      , 1 Rp        , Rr          , Gs^Fds      , Gs^Fds      , Hh^Fds      , Mm          , Mm          , Wwf         , Hh^Fds      , Gs^Fms      , Gg^Ve       , Gs          , Gs          , Gs          , Gs          , Gs^Fds      , Mm          , Gs^Fds      , Re^Gvs      , Re^Gvs      , Gg^Ve       , Gs^Fds      , Gs^Fds      
Gs^Fds      , Gs^Fds      , Gs^Fds      , Gs^Fds      , Gs          , Ggf         , Gg^Ve       , Re          , Rd          , Gs^Fms      , Gs^Fms      , Gs^Fds      , Gs^Fds      , Gs^Fds      , Rp          , Gs^Fds      , Gs^Fds      , Gs^Fms      , Hh^Fds      , Wwf         , Wwf         , Mm          , Gs^Fds      , Gs^Fms      , Ggf         , Gs^Fds      , Gs^Fds      , Gs^Fds      , Gs^Fds      , Mm          , Gs^Fds      , Gs^Fds      , Re^Gvs      , Ggf         , Gs          , Ggf         , Gs^Fms      
Hh^Fds      , Hh^Fds      , Gs^Fds      , Gs^Fds      , Gg^Ve       , Ggf         , Gs^Fds      , Gs^Fms      , Gs^Fp       , Gs^Fp       , Gs^Fp       , Gs^Fp       , Gs^Fds      , Gs^Fds      , Rp          , Rp          , Gs^Fds      , Gs^Fds      , Gs^Fds      , Wwf         , Gs^Fp       , Gs^Fds      , Mm          , Mm          , Gs^Fds      , Gs^Fds      , Gg^Fet      , Mm          , Gs^Fms      , Gs^Fp       , Gs^Fds      , Gs          , Gs          , Gs          , Gs          , Ggf         , Hh^Fms      
Mm          , Gs^Fds      , Gs^Fds      , Gg^Ve       , Ggf         , Re          , Re          , Gs^Fp       , Gs^Fp       , Gs^Fp       , Gs^Fp       , Gs^Fp       , Gs^Fds      , Gs^Fds      , Rr          , Rp          , Gs^Fds      , Gs^Fds      , Gs^Fds      , Wwf         , Gs^Fds      , Gs^Fds      , Gs^Fds      , Gs^Fds      , Mm          , Mm          , Mm          , Gs^Fp       , Gs^Fp       , Gs^Fp       , Gs          , Gs          , Gs          , Gs          , Ggf         , Hh^Fms      , Hh^Fms      
Mm          , Gs^Fp       , Gs^Fds      , Gs^Fds      , Gs^Fds      , Gs^Fp       , Gs^Fp       , Gs^Fp       , Gs^Fp       , Gs^Fp       , Gs^Fp       , Gs^Fp       , Gs^Fds      , Gs^Fds      , Rp          , Rr          , Gs^Fds      , Gs^Fds      , Wwf         , Gs^Fds      , Ds          , Hd          , Ds          , Gs^Fds      , Mm          , Mm          , Mm          , Mm          , Gs^Fp       , Gs^Fp       , Gs^Fp       , Gs^Fms      , Gs          , Gs          , Gs          , Hh^Fms      , Hh^Fms      
Gs^Fds      , Gs^Fds      , Gs^Fds      , Gs^Fds      , Gs^Fds      , Gs^Fms      , Gs^Fp       , Gs^Fp       , Gs^Fp       , Gs^Fp       , Gs^Fp       , Gs^Fp       , Gs^Fds      , Gg          , Rp          , Rr          , Gs^Fds      , Gs^Fds      , Wwf         , Ds          , Ds          , Gs^Fds      , Ds          , Gs^Fds      , Gs^Fds      , Gs^Fds      , Mm          , Gs^Fms      , Mm          , Gs^Fms      , Gs^Fp       , Gs^Fds      , Gs^Fds      , Hh^Fms      , Hh^Fms      , Hh^Fms      , Hh^Fms      
