border_size=1
usage=map

Mm^Xm       , Mm^Xm       , Mm^Xm       , Mm^Xm       , Mm^Xm       , Mm^Xm       , Mm^Xm       , Mm^Xm       , Mm          , Mm          , Mm          , Hh^Fp       , Hh^Fp       , Hh^Fp       , Hh^Fp       , Mm          , Mm          , Mm          , Mm          , Re          , Mm          , Mm          , Mm          , Mm          , Mm          , Mm          , Mm          , Mm          , Mm          , Mm          , Mm          , Mm          , Mm          , Mm          , Mm          , Mm          , Gs^Fmf      , Gs^Fmf      , Gs^Fmf      , Gs^Fmf      , Gs^Fmf      , Gs^Fmf      , Gs^Fmf      , Mm          , Mm          
Mm^Xm       , Mm^Xm       , Mm          , Mm          , Mm          , Mm^Xm       , Mm^Vhh      , Mm          , Mm          , Mm          , Mm          , Hh^Fp       , Hh^Fp       , Hh^Fp       , Hh^Fp       , Mm          , Mm          , Mm          , Mm          , Re          , Mm          , Mm          , Mm          , Mm          , Mm          , Mm          , Mm          , Mm          , Mm          , Mm          , Mm          , Mm          , Mm          , Mm          , Mm          , Gs^Fmf      , Gs^Fmf      , Gs^Fmf      , Gs^Fmf      , Gs^Fmf      , Gs^Fmf      , Gs^Fmf      , Gs^Fmf      , Gs^Fmf      , Gs^Fmf      
Ce          , Ce          , Ce          , Ce          , Mm          , Mm          , Mm          , Mm          , Mm          , Mm          , Mm          , Hh^Fp       , Hh^Fp       , Hh^Fp       , Gg^Ve       , Mm          , Mm          , Mm          , Re          , Re          , Hh          , Hh          , Hh          , Mm          , Mm          , Mm          , Mm          , Mm          , Mm          , Mm          , Mm          , Mm          , Mm          , Mm          , Mm          , Mm          , Mm          , Gs^Fmf      , Gs^Fmf      , Gs^Fmf      , Gs^Fmf      , Gs^Fmf      , Gs^Fmf      , Gs^Fmf      , Gs^Fmf      
Ce          , Ce          , 4 Ke        , Ce          , Mm          , Hh          , Hh          , Hh          , Hh          , Mm          , Gg^Ve       , Hh^Fp       , Hh^Fp       , Mm          , Mm          , Mm          , Mm          , Re          , Re          , Re          , Mm          , Hh          , Hh          , Hh          , Hh          , Hh^Fp       , Hh^Fp       , Hh^Fp       , Gg          , Mm          , Mm          , Mm          , Mm          , Mm          , Mm          , Mm          , Mm          , Gs^Fmf      , Gs^Fmf      , Gs^Fmf      , Gs^Fmf      , Gs^Fmf      , Gs^Fmf      , Gs^Fmf      , Mm          
Ce          , Ce          , Ce          , Ce          , Hh          , Hh          , Gs          , Hh          , Hh          , Hh          , Hh          , Hh          , Hh          , Hh          , Hh          , Hh          , Re          , Re          , Hh          , Re          , Re          , Hh          , Hh          , Mm          , Mm          , Mm          , Mm          , Mm          , Hh          , Hh          , Hh          , Hh          , Hh          , Hh          , Hh          , Mm          , Mm          , Mm          , Mm          , Gs^Fmf      , Gs^Fmf      , Mm          , Gs^Fmf      , Gs^Fmf      , Gs^Fmf      
Hh          , Hh          , Hh          , Hh          , Hh          , Hh          , Hh^Fp       , Hh^Fp       , Hh^Fp       , Hh          , Hh          , Hh          , Mm          , Mm          , Mm          , Re          , Re          , Mm          , Ms          , Mm          , Ms          , Re          , Re          , Mm          , Mm          , Mm          , Mm          , Mm          , Mm          , Mm          , Hh          , Hh          , Hh          , Mm          , Mm          , Ww          , Mm          , Mm          , Mm          , Mm          , Mm          , Gs^Fmf      , Gs^Fmf      , Gs^Fmf      , Mm          
Hh          , Hh          , Hh          , Hh          , Hh          , Hh^Fp       , Hh^Fp       , Hh^Fp       , Hh^Fp       , Hh          , Hh          , Hh          , Hh          , Mm          , Re          , Re          , Hh          , Ms          , Mm          , Ms          , Ms          , Ms          , Re          , Mm          , Mm          , Mm          , Mm          , Mm          , Hh^Fp       , Mm          , Mm          , Mm          , Mm          , Mm          , Ww          , Ww          , Hh          , Hh          , Hh          , Hh          , Hh          , Gs^Fmf      , Gs^Fmf      , Hh          , Hh          
Hh          , Hh          , Gg          , Hh          , Re          , Hd          , Hh^Fp       , Hh^Fp       , Hh^Fp       , Hh          , Hh          , Re          , Re          , Re          , Re          , Mm          , Ww          , Ww          , Mm          , Ms          , Hh          , Hh          , Re          , Hh          , Hh          , Hh          , Hh          , Hh^Fp       , Hh          , Hh^Fp       , Hh^Fp       , Hh^Fp       , Hh          , Hh          , Ww          , Ww          , Hh          , Hh          , Hh          , Hh          , Hh          , Gs^Fmf      , Gs^Fmf      , Gs^Fmf      , Hh          
Hh          , Hh          , Hh          , Hh          , Hd          , Hd          , Hh^Fp       , Hh^Fp       , Hh^Fp       , Hh          , Hh          , Re          , Re          , Re          , Ww          , Ww          , Wo          , Wo          , Ww          , Mm          , Mm          , Mm          , Re          , Hh          , Hh          , Hh          , Hh          , Hh          , Hh          , Hh^Fp       , Hh^Fp       , Hh^Fp       , Hh          , Hh          , Ww          , Ww          , Hh^Fp       , Hh^Fp       , Hh          , Hh^Fp       , Hh          , Hh          , Gs^Fmf      , Gs^Fmf      , Hh          
Hh          , Hh          , Hh          , Hh          , Hh          , Hd          , Hh^Fp       , Hh^Fp       , Hh          , Hh          , Hh          , Re          , Re          , Ww          , Ww          , Wo          , Wo          , Wo          , Wo          , Wo          , Ww          , Ww          , Re          , Mm          , Mm          , Mm          , Mm          , Mm          , Mm          , Mm          , Mm          , Mm          , Mm          , Ww          , Ww          , Hh^Fp       , Ww          , Ww          , Ww          , Ww          , Ww          , Ww          , Gs^Fmf      , Ww          , Ww          
Hh          , Hh          , Hh          , Ggf         , Hh          , Hh^Fp       , Hh^Fp       , Hh          , Mm          , Re          , Re          , Re          , Ww          , Ww          , Wo          , Ww          , Ww          , Ww          , Ww          , Ww          , Re          , Re          , Mm          , Mm          , Mm          , Mm          , Mm          , Mm          , Mm          , Mm          , Gg          , Gg          , Gg          , Gg          , Hh^Fp       , Hh^Fp       , Ww          , Ww          , Ww          , Ww          , Ww          , Ww          , Gs^Fmf      , Ww          , Ww          
Hh          , Hh          , Hh          , Hh          , Hh          , Hh^Fp       , Hh^Fp       , Hh^Fp       , Mm          , Re          , Re          , Re          , Mm          , Mm          , Ww          , Ww          , Ww          , Ww          , Ww          , Re          , Mm          , Mm          , Mm          , Mm          , Mm          , Mm          , Mm          , Mm          , Mm          , Gg          , Gg          , Mm          , Mm          , Mm          , Ww          , Wo          , Ww          , Ww          , Ww          , Ww          , Ww          , Ww          , Gs^Fmf      , Ww          , Ww          
Mm          , Mm          , Hh          , Ce          , Ce          , Mm          , Mm          , Mm          , Re          , Re          , Re          , Hh          , Hh          , Hh          , Hh^Fp       , Hh^Fp       , Hh^Fp       , Hh^Fp       , Hh^Fp       , Re          , Re          , Mm          , Mm          , Mm          , Re          , Re          , Mm          , Mm          , Mm          , Mm          , Gg          , Mm          , Mm          , Ww          , Wo          , Ww          , Ww          , Ww          , Ww          , Ww          , Ww          , Gs^Fmf      , Gs^Fmf      , Ww          , Ww          
Mm          , Mm          , Mm          , Hh          , Mm          , Mm          , Mm          , Gs^Fp       , Re          , Re          , Re          , Mm          , Mm          , Hh          , Hh          , Hh          , Re          , Re          , Re          , Re          , Re          , Re          , Re          , Mm          , Re          , Re          , Mm          , Mm          , Mm          , Mm          , Gg          , Gg          , Mm          , Ww          , Wo          , Wo          , Ww          , Ww          , Ww          , Ww          , Ww          , Gs^Fmf      , Gs^Fmf      , Ww          , Ww          
Gs^Fp       , Gs^Fp       , Gs^Fp       , Gs^Fp       , Gs^Fp       , Gs^Fp       , Gs^Fp       , Gg          , Gs^Fp       , Gs^Fp       , Gs^Fp       , Mm          , Mm          , Mm          , Re          , Re          , Mm          , Mm          , Mm          , Mm          , Mm          , Mm          , Mm          , Hh^Vhh      , Re          , Mm          , Mm          , Mm          , Hh^Fp       , Gg          , Mm          , Mm          , Mm          , Mm          , Mm          , Mm          , Ww^Bw\      , Ww          , Ww          , Ww          , Ww          , Gs^Fmf      , Ww          , Ww          , Ww          
Gs^Fp       , Gs^Fp       , Gs^Fp       , Gg          , Gg          , Gs^Fp       , Gs^Fp       , Gs^Fp       , Gs^Fp       , Gs^Fp       , Gs^Fp       , Hh          , Gs^Fms      , Hh          , Re          , Mm          , Mm          , Mm          , Mm          , Mm          , Mm          , Mm          , Mm          , Mm          , Re          , Hh          , Hh          , Mm          , Mm          , Gg          , Mm          , Mm          , Ce          , Ce          , Ce          , Mm          , Mm          , Mm          , Mm          , Mm          , Gs^Fmf      , Gs^Fmf      , Mm          , Mm          , Mm          
Gs^Fp       , Gs^Fp       , Gs^Fp       , Gs^Fp       , Gg          , Gg          , Gg          , Hh          , Hh          , Hh          , Re          , Re          , Gs^Fms      , Gs^Fms      , Gs^Fms      , Re          , Re          , Re          , Re          , Re          , Re          , Re          , Re          , Re          , Mm          , Mm          , Mm          , Mm          , Mm          , Gg          , Mm          , Mm          , Ce          , 2 Ke        , Ce          , Ce          , Mm          , Mm          , Mm          , Mm          , Gs^Fmf      , Gs^Fmf      , Mm          , Mm          , Mm          
Mm          , Mm          , Mm          , Mm          , Gg^Ve       , Mm          , Hh          , Hh          , Hh          , Hh          , Hh          , Hh          , Gg          , Re          , Re          , Gg^Ve       , Re          , Re          , Hh          , Hh          , Hh          , Hh          , Hh          , Mm          , Mm          , Hh^Fp       , Gg          , Gg          , Gg          , Gg          , Hh^Fp       , Mm          , Ce          , Ce          , Ce          , Ce          , Mm          , Mm          , Mm          , Mm          , Gs^Fmf      , Gs^Fmf      , Mm          , Mm          , Mm          
Ww          , Mm          , Mm          , Mm          , Mm          , Mm          , Mm          , Hh          , Hh          , Hh^Fms      , Hh          , Hh          , Ww          , Ww          , Ww^Bw|      , Re          , Gg          , Hh          , Hh          , Hh          , Hh          , Mm          , Mm          , Mm          , Mm          , Gg          , Mm          , Mm          , Mm          , Mm          , Mm          , Mm          , Mm          , Mm          , Mm          , Mm          , Mm          , Mm          , Mm          , Mm          , Mm          , Mm          , Mm          , Mm          , Mm          
Mm          , Ww          , Ww          , Ww          , Ww          , Hh^Fms      , Ww          , Gs^Fms      , Hh^Fms      , Hh^Fms      , Ww          , Ww          , Ww          , Ww          , Hh          , Ww          , Ww          , Hh          , Ww          , Hh          , Hh          , Hh          , Hh          , Mm          , Mm          , Gg          , Gg          , Mm          , Mm          , Mm          , Mm          , Mm          , Mm          , Mm          , Mm          , Mm          , Mm          , Mm          , Mm          , Mm          , Mm          , Hh^Fms      , Hh^Fms      , Hh^Fms      , Mm          
Mm          , Mm          , Mm          , Ww          , Gs^Fms      , Ww          , Hh^Fms      , Ww          , Ww          , Ww          , Gs^Fms      , Ww          , Hh          , Gg          , Gg          , Gg          , Gg          , Ww          , Ww          , Ww          , Ww          , Mm          , Mm          , Mm          , Mm          , Mm          , Hh          , Gg          , Gg          , Mm          , Mm          , Mm          , Mm          , Mm          , Mm          , Mm          , Gs^Fmf      , Gs^Fmf      , Mm          , Mm          , Hh^Fms      , Hh^Fms      , Hh^Fms      , Hh^Fms      , Mm          
Mm          , Mm          , Mm          , Mm          , Mm          , Mm          , Mm          , Mm          , Mm          , Gg          , Gg          , Gg          , Ggf         , Gg          , Gg          , Ggf         , Gs^Fms      , Hh^Fms      , Gs^Fms      , Ww          , Ww          , Mm          , Mm          , Mm          , Mm          , Mm          , Mm          , Gg          , Hh^Fp       , Hh^Fp       , Hh^Fp       , Mm          , Mm          , Mm          , Mm          , Mm          , Mm          , Gs^Fmf      , Hh^Fms      , Hh^Fms      , Hh^Fms      , Hh^Fms      , Mm          , Mm          , Mm          
Mm          , Mm          , Mm          , Mm          , Mm          , Mm          , Mm          , Mm          , Hh^Vhh      , Mm          , Gg          , Gg          , Gg          , Gg          , Gg          , Gg          , Gg          , Gg          , Gg          , Gg          , Gg          , Ww          , Ww          , Hh          , Mm          , Mm          , Gg          , Gg          , Hh^Fp       , Hh^Fp       , Mm          , Mm          , Mm          , Mm          , Mm          , Mm          , Mm          , Hh^Fms      , Gs^Fmf      , Gs^Fmf      , Hh^Fms      , Hh^Fms      , Mm          , Mm          , Mm          
Mm          , Mm          , Mm          , Mm          , Mm          , Mm          , Mm          , Mm          , Hh          , Hh          , Hh          , Hh          , Hh          , Hh          , Gs^Fds      , Re          , Gg^Ve       , Gs^Fds      , Gs^Fds      , Hh          , Hh          , Hh          , Hh          , Ww          , Ww          , Gg          , Ww          , Ww          , Ww          , Mm          , Mm          , Mm          , Mm          , Mm          , Mm          , Mm          , Mm          , Gs^Fmf      , Hh^Fms      , Hh^Fms      , Hh^Fms      , Hh^Fms      , Hh^Fms      , Mm          , Mm          
Mm          , Mm          , Mm          , Mm          , Mm          , Mm^Vhh      , Mm          , Hh^Fms      , Hh^Fds      , Hh^Fms      , Gs^Fds      , Gs^Fds      , Gs^Fds      , Gg          , Re          , Gg          , Hh          , Hh          , Mm          , Gs^Fds      , Gs^Fds      , Hh          , Gg          , Gg          , Hh          , Ww          , Hh          , Mm          , Ww          , Mm          , Mm          , Mm          , Mm          , Mm          , Mm          , Mm          , Mm          , Hh^Fms      , Hh^Fms      , Hh^Fms      , Hh^Fms      , Hh^Fms      , Hh^Fms      , Mm          , Mm          
Mm          , Mm          , Mm          , Mm          , Mm          , Mm          , Mm          , Mm          , Mm          , Hh          , Hh          , Hh          , Hh          , Gs^Fds      , Gs^Fds      , Gs^Fds      , Gs^Fds      , Gs^Fds      , Gs^Fds      , Gs^Fds      , Gs^Fds      , Gs^Fds      , Hh^Fp       , Hh          , Mm          , Hh          , Mm          , Mm          , Mm          , Ww          , Ww          , Mm          , Mm          , Mm          , Ww          , Ww          , Ww          , Hh^Fms      , Hh^Fms      , Hh^Fms      , Hh^Fms      , Hh^Fms      , Hh^Fms      , Hh^Fms      , Mm          
Mm          , Mm          , Mm          , Mm          , Mm          , Mm          , Mm          , Mm          , Mm          , Mm          , Mm          , Mm          , Mm          , Mm          , Gg          , Gg          , Gg          , Gg          , Gg          , Gs^Fds      , Gs^Fds      , Hh^Fp       , Gs^Fds      , Gs^Fds      , Gg          , Gg          , Gg          , Hh          , Hh          , Mm          , Mm          , Ww          , Ww          , Ww          , Mm          , Mm          , Mm          , Ww          , Ww          , Hh^Fms      , Gs^Fmf      , Hh^Fms      , Hh^Fms      , Hh^Fms      , Mm          
Mm          , Mm          , Mm          , Mm          , Mm          , Mm          , Mm          , Mm^Vhh      , Mm          , Mm          , Mm          , Mm          , Gs^Fds      , Gs^Fds      , Gs^Fds      , Gs^Fds      , Gs^Fds      , Gs^Fds      , Gg          , Gs^Fds      , Hh^Fp       , Hh^Fp       , Hh^Fp       , Gs^Fds      , Gs^Fds      , Gs^Fds      , Gs^Fds      , Mm          , Hh          , Hh^Fp       , Hh^Fp       , Hh^Fp       , Hh^Fp       , Mm          , Mm          , Mm          , Mm          , Mm          , Mm          , Ww          , Hh^Fms      , Hh^Fms      , Hh^Fms      , Mm          , Mm          
Mm          , Mm          , Hh          , Mm          , Mm^Vhh      , Mm          , Mm          , Mm          , Mm          , Mm          , Gg^Ve       , Mm          , Mm          , Gs^Fds      , Gg          , Gs^Fds      , Gs^Fmw      , Gg          , Gs^Fds      , Gg          , Gs^Fds      , Hh^Fp       , Gs^Fds      , Hh^Fp       , Hh^Fp       , Gs^Fds      , Gs^Fds      , Gg^Ve       , Gg          , Hh^Fp       , Hh^Fp       , Hh^Fp       , Hh^Fp       , Hh^Fp       , Hh^Fp       , Mm          , Mm          , Mm          , Ww          , Ww          , Hh^Fms      , Hh^Fms      , Hh^Fms      , Hh^Fms      , Hh^Fms      
Mm          , Mm          , Mm          , Mm          , Mm          , Mm          , Mm          , Gs^Fds      , Gs^Fds      , Gs^Fds      , Gs^Fds      , Gg^Ve       , Gs^Fds      , Gs^Fds      , Gg          , Gs^Fds      , Gs^Fds      , Gs^Fds      , Gs^Fds      , Gg          , Gs^Fds      , Gs^Fds      , Gs^Fds      , Gg          , Hh^Fp       , Gs^Fds      , Gs^Fds      , Gs^Fds      , Gs^Fds      , Mm          , Hh          , Hh          , Hh          , Hh          , Hh          , Mm          , Ww          , Ww          , Hh^Fms      , Hh^Fms      , Hh^Fms      , Hh^Fms      , Hh^Fms      , Mm          , Mm          
Hh          , Hh          , Mm          , Mm          , Mm          , Mm          , Gg^Ve       , Gs^Fds      , Gs^Fds      , Gs^Fds      , Gs^Fds      , Gs^Fds      , Gs^Fds      , Gs^Fds      , Gg          , Gg          , Gs^Fds      , Gs^Fmw      , Gs^Fmw      , Gg          , Gs^Fds      , Gs^Fds      , Gs^Fds      , Gg          , Hh^Fp       , Gs^Fds      , Gg^Ve       , Mm          , Mm          , Mm          , Mm          , Mm          , Mm          , Mm          , Ww          , Ww          , Hh^Fms      , Mm          , Hh^Fms      , Hh^Fms      , Mm          , Mm          , Hh^Fms      , Mm          , Mm          
Mm          , Mm          , Mm          , Mm          , Mm          , Hh^Fp       , Hh^Fp       , Hh^Fp       , Hh^Fp       , Gs^Fds      , Gs^Fds      , Gs^Fds      , Hh^Fp       , Gs^Fds      , Gs^Fds      , Gg          , Gs^Fds      , Gs^Fmw      , Gg          , Gg          , 5 Gg        , Gs^Fds      , Gs^Fds      , Gg          , Gg          , Gs^Fds      , Gs^Fds      , Gs^Fds      , Gs^Fds      , Gs^Fds      , Mm          , Mm          , Mm          , Mm          , Mm          , Ww          , Ww          , Hh^Fms      , Mm          , Hh^Fms      , Mm          , Hh^Fms      , Mm          , Mm          , Mm          
Mm          , Mm          , Mm          , Mm          , Mm          , Mm          , Mm          , Hh          , Hh          , Hh^Fp       , Hh^Fp       , Hh^Fp       , Hh^Fp       , Gs^Fds      , Gs^Fds      , Gs^Fds      , Gs^Fds      , Gg          , Gg          , Gg          , Gs^Fmw      , Gs^Fds      , Gs^Fds      , Gs^Fds      , Gg          , Gs^Fds      , Gs^Fds      , Gs^Fds      , Mm          , Mm          , Mm          , Mm          , Mm          , Mm          , Mm          , Hh^Fms      , Mm          , Ww          , Ww          , Hh^Fms      , Hh^Fms      , Hh^Fms      , Hh^Fms      , Mm          , Mm          
Mm          , Mm          , Mm          , Mm          , Mm          , Mm          , Mm          , Hh          , Hh          , Gs^Fds      , Hh^Fp       , Hh^Fp       , Gs^Fds      , Hh^Fp       , Gg          , Gs^Fds      , Gs^Fmw      , Gg          , Gg          , Gs^Fds      , Gs^Fds      , Gs^Fds      , Ce          , Gs^Fds      , Gs^Fds      , Gs^Fds      , Hh^Fp       , Gs^Fds      , Hh^Fms      , Hh^Fms      , Hh^Fms      , Hh^Fms      , Hh^Fp       , Mm          , Hh^Fp       , Hh^Fms      , Hh^Fp       , Hh^Fms      , Ww          , Mm          , Hh^Fms      , Hh^Fms      , Hh^Fms      , Mm          , Mm          
Mm          , Mm          , Mm          , Mm          , Mm          , Mm          , Mm          , Hh          , Hh          , Gs^Fds      , Hh^Fp       , Gs^Fds      , Gs^Fds      , Gs^Fmw      , Gs^Fds      , Hh^Fp       , Hh^Fp       , Gg          , Gg          , Gs^Fds      , Gs^Fds      , Ce          , 3 Ke        , Ce          , Hh^Fp       , Hh^Fp       , Hh^Fp       , Hh^Fms      , Hh^Fms      , Hh^Fms      , Hh^Fms      , Hh^Fp       , Hh^Fp       , Hh^Fp       , Mm          , Hh^Fp       , Mm          , Hh^Fp       , Ww          , Hh^Fms      , Hh^Fp       , Hh^Fms      , Mm          , Mm          , Mm          
Mm          , Mm          , Mm          , Mm          , Mm          , Mm          , Mm          , Hh          , Hh          , Gs^Fds      , Gs^Fds      , Hh^Fp       , Hh^Fp       , Hh^Fp       , Hh^Fp       , Hh^Fp       , Hh^Fp       , Gg          , Gg          , Gs^Fmw      , Gs^Fds      , Ce          , Ce          , Ce          , Hh^Fp       , Hh^Fp       , Gs^Fds      , Hh^Fms      , Hh^Fms      , Hh^Fms      , Hh^Fms      , Hh^Fms      , Hh^Fms      , Hh^Fp       , Mm          , Mm          , Hh^Fms      , Hh^Fms      , Ww          , Hh^Fp       , Hh^Fms      , Hh^Fp       , Mm          , Mm          , Mm          
Mm          , Mm          , Mm          , Mm          , Mm          , Mm          , Mm          , Hh          , Hh          , Gs^Fds      , Gs^Fds      , Gs^Fds      , Gs^Fds      , Gs^Fds      , Gs^Fds      , Gs^Fds      , Gg          , Gg          , Gg          , Gs^Fds      , Gs^Fds      , Hh^Fp       , Gs^Fds      , Gs^Fmw      , Hh^Fp       , Gs^Fds      , Gs^Fds      , Gs^Fds      , Mm          , Mm          , Hh^Fms      , Hh^Fms      , Hh^Fp       , Hh^Fms      , Hh^Fp       , Hh^Fp       , Hh^Fp       , Hh^Fp       , Hh^Fms      , Ww          , Mm          , Mm          , Mm          , Mm          , Mm          
Mm          , Mm          , Mm          , Mm          , Mm          , Mm          , Mm          , Hh          , Hh          , Gs^Fds      , Mm          , Gs^Fds      , Mm          , Gs^Fds      , Gs^Fds      , Gg          , Ce          , Gg          , Gs^Fds      , Gs^Fds      , Gs^Fds      , Gs^Fds      , Gs^Fds      , Hh^Fp       , Gs^Fds      , Gs^Fds      , Gs^Fds      , Gs^Fds      , Hh^Fms      , Hh^Fms      , Hh^Fp       , Hh^Fp       , Hh^Fms      , Hh^Fp       , Hh^Fms      , Hh^Fms      , Mm          , Mm          , Hh^Fms      , Ww          , Mm          , Mm          , Mm          , Mm          , Mm          
Mm          , Mm          , Mm          , Mm          , Mm          , Mm          , Mm          , Mm          , Mm          , Mm          , Mm          , Mm          , Hh^Fp       , Mm          , 1 Ke        , Ce          , Mm          , Hh^Fp       , Gs^Fmw      , Hh^Fp       , Hh^Fp       , Gs^Fmw      , Hh^Fp       , Hh^Fp       , Hh^Fp       , Gs^Fds      , Hh^Fp       , Hh^Fms      , Hh^Fms      , Hh^Fms      , Hh^Fp       , Mm          , Hh^Fms      , Hh^Fms      , Hh^Fms      , Hh^Fms      , Hh^Fms      , Hh^Fms      , Hh^Fms      , Ww          , Mm          , Mm          , Mm          , Mm          , Mm          
Mm          , Mm          , Mm          , Mm          , Mm          , Mm          , Mm          , Hh          , Hh          , Mm          , Gs^Fds      , Mm          , Mm^Cov      , Mm^Cov      , Mm          , Mm          , Gs^Fds      , Gs^Fmw      , Mm          , Gs^Fds      , Gs^Fds      , Gs^Fds      , Gs^Fds      , Hh^Fp       , Gs^Fds      , Hh^Fp       , Gs^Fds      , Hh^Fms      , Hh^Fp       , Hh^Fms      , Hh^Fp       , Hh^Fp       , Hh^Fp       , Hh^Fms      , Hh^Fp       , Hh^Fms      , Hh^Fms      , Hh^Fms      , Mm          , Ww          , Ww          , Mm          , Ww          , Mm          , Ww          
Mm          , Mm          , Mm          , Mm          , Mm          , Mm          , Mm          , Hh          , Hh          , Gs^Fds      , Gs^Fds      , Ce          , Ce          , Mm          , Mm          , Mm          , Mm          , Gs^Fds      , Mm          , Mm          , Mm          , Mm          , Mm          , Mm          , Mm          , Mm          , Mm          , Mm          , Mm          , Mm          , Hh^Fms      , Hh^Fms      , Hh^Fms      , Hh^Fp       , Hh^Fp       , Hh^Fp       , Hh^Fms      , Hh^Fms      , Hh^Fms      , Hh^Fms      , Hh^Fms      , Ww          , Mm          , Ww          , Mm          
Mm          , Mm          , Mm          , Mm          , Mm          , Mm          , Mm          , Hh          , Hh          , Gs^Fds      , Gs^Fds      , Gs^Fds      , Gs^Fds      , Ce          , Gs^Fds      , Mm          , Mm          , Mm          , Gs^Fds      , Gs^Fds      , Hh^Fp       , Hh^Fp       , Gs^Fds      , Gs^Fds      , Gs^Fds      , Gs^Fds      , Gs^Fds      , Gs^Fds      , Mm          , Hh^Fp       , Hh^Fp       , Hh^Fms      , Hh^Fms      , Hh^Fms      , Hh^Fp       , Hh^Fms      , Hh^Fms      , Hh^Fms      , Mm          , Mm          , Mm          , Mm          , Mm          , Mm          , Mm          
Mm          , Mm          , Mm          , Mm          , Mm          , Mm          , Mm          , Hh          , Hh          , Gs^Fds      , Gs^Fds      , Gs^Fds      , Gs^Fds      , Gs^Fds      , Gs^Fds      , Gs^Fds      , Mm          , Mm          , Mm          , Hh^Fp       , Mm          , Gs^Fds      , Gs^Fds      , Gs^Fds      , Gs^Fds      , Gs^Fds      , Gs^Fds      , Gs^Fds      , Mm          , Mm          , Mm          , Hh^Fp       , Hh^Fp       , Hh^Fp       , Mm          , Mm          , Mm          , Mm          , Mm          , Mm          , Mm          , Mm          , Mm          , Mm          , Mm          
Mm          , Mm          , Mm          , Mm          , Mm          , Mm          , Mm          , Hh          , Hh          , Gs^Fds      , Gs^Fds      , Gs^Fds      , Gs^Fds      , Gs^Fds      , Gs^Fds      , Gs^Fds      , Gs^Fds      , Mm          , Gs^Fds      , Mm          , Gs^Fds      , Gs^Fds      , Gs^Fds      , Gs^Fds      , Gs^Fds      , Gs^Fds      , Gs^Fds      , Gs^Fds      , Mm          , Mm          , Mm          , Mm          , Mm          , Mm          , Mm          , Mm          , Mm          , Mm          , Mm          , Mm          , Mm          , Mm          , Mm          , Mm          , Mm          
