border_size=1
usage=map

Wo          , Wo          , Wo          , Wo          , Wo          , Wo          , Wo          , Wo          , Wo          , Wo          , Wo          , Wo          , Wo          , Wo          , Wo          , Wo          , Wo          , Wo          , Wo          , Wo          , Wo          , Ww          , Ds          , Gg          , Gg          , Gg          , Gg          , Gs^Fms      , Gs^Fms      , Gs^Fp       , Gs^Fp       , Gs^Fp       , Gs^Fp       , Gs^Fp       , Gs^Fp       , Gg          , Gg          , Gg          , Gg          , Gg          , Gs^Fms      , Gg          , Gg          
Wo          , Wo          , Wo          , Wo          , Wo          , Wo          , Wo          , Wo          , Wo          , Wo          , Wo          , Wo          , Wo          , Wo          , Wo          , Wo          , Wo          , Wo          , Wo          , Wo          , Wo          , Ww          , Ds          , Gg          , Gs^Fms      , Gg          , Gg          , Gs^Fds      , Gs^Fms      , Gs^Fms      , Gs^Fms      , Gs^Fp       , Gs^Fms      , Gs^Fp       , Gs^Fp       , Gg          , Gg          , Gs^Fms      , Gs^Fms      , Gs^Fms      , Gg          , Gg          , Gg          
Wo          , Wo          , Wo          , Wo          , Wo          , Wo          , Wo          , Wo          , Wo          , Wo          , Wo          , Wo          , Wo          , Wo          , Wo          , Wo          , Wo          , Wo          , Wo          , Wo          , Wo          , Ww          , Ds          , Gs^Fms      , Gg          , Gg          , Gg          , Gs^Fds      , Gg          , Gs^Fds      , Gs^Fms      , Gs^Fms      , Gs^Fms      , Gs^Fp       , Gg          , Gs^Fp       , Gg          , Gs          , Gs          , Gg          , Gs^Fp       , Gg          , Gg          
Wo          , Wo          , Wo          , Wo          , Wo          , Wo          , Wo          , Wo          , Wo          , Wo          , Wo          , Wo          , Wo          , Wo          , Wo          , Wo          , Wo          , Wo          , Wo          , Wo          , Wo          , Ww          , Ds          , Gg          , Gg          , Gg^Vh       , Gg          , Gg          , Gg          , Gs^Fms      , Gs^Fms      , Gs^Fds      , Gs^Fms      , Gs^Fms      , Gs^Fp       , Gs^Fp       , Gg          , Gg          , Gg          , Gs          , Gs^Fp       , Gg          , Gg          
Wo          , Wo          , Wo          , Wo          , Wo          , Wo          , Wo          , Wo          , Wo          , Wo          , Wo          , Wo          , Wo          , Wo          , Wo          , Wo          , Wo          , Wo          , Wo          , Wo          , Wo          , Ww          , Ds          , Gg          , Gg          , Gg          , Gs^Fms      , Gg          , Gg          , Gg          , Gs^Fds      , Gs^Fms      , Gs^Fms      , Gs^Fms      , Gg          , Gs^Fp       , Gg          , Gg          , Gs          , Gs^Fp       , Gs^Fp       , Gg          , Gg          
Wo          , Wo          , Wo          , Wo          , Wo          , Wo          , Wo          , Wo          , Wo          , Wo          , Wo          , Wo          , Wo          , Wo          , Wo          , Wo          , Wo          , Wo          , Wo          , Wo          , Wo          , Ww          , Ww          , Ds          , Gg          , Gs^Fms      , Gs^Fms      , Gg          , Gg          , Gg          , Gs^Fds      , Gs^Fms      , Gs^Fds      , Gs^Fds      , Gs^Fms      , Gs^Fms      , Gg          , Gg          , Gs          , Gs          , Gs          , Gg          , Gg          
Wo          , Wo          , Wo          , Wo          , Wo          , Wo          , Wo          , Wo          , Wo          , Wo          , Wo          , Wo          , Wo          , Wo          , Wo          , Wo          , Wo          , Wo          , Wo          , Wo          , Wo          , Ww          , Ww          , Ds          , Ds          , Gg          , Gg          , Gg          , Gg          , Gg          , Gg^Vh       , Gs^Fds      , Gs^Fds      , Gs^Fms      , Gs^Fms      , Gs^Fms      , Gg          , Gg          , Gs          , Gg          , Gs          , Gg          , Gg          
Wo          , Wo          , Wo          , Wo          , Wo          , Wo          , Wo          , Wo          , Wo          , Wo          , Wo          , Wo          , Wo          , Wo          , Wo          , Wo          , Wo          , Wo          , Wo          , Wo          , Wo          , Wo          , Ww          , Ds          , Ds          , Ds          , Ds          , Gg          , Gg          , Gg          , Gg          , Gs^Fds      , Gs^Fds      , Gs^Fds      , Gs^Fms      , Gs^Fms      , Gs^Fms      , Gs^Fms      , Gs^Fms      , Gg^Vh       , Gs          , Gg          , Gg          
Wo          , Wo          , Wo          , Wo          , Wo          , Wo          , Wo          , Wo          , Wo          , Wo          , Wo          , Wo          , Wo          , Wo          , Wo          , Wo          , Wo          , Wo          , Wo          , Wo          , Wo          , Wo          , Wo          , Ww          , Ds          , Gg          , Gg          , Gg          , Gs^Fms      , Gg          , Gg          , Gs^Fms      , Gs^Fms      , Gs^Fds      , Gs^Fms      , Gs^Fms      , Gg          , Gs          , Gs          , Gs          , Gg          , Gg          , Gg          
Wo          , Wo          , Wo          , Wo          , Wo          , Wo          , Wo          , Wo          , Wo          , Wo          , Wo          , Wo          , Wo          , Wo          , Wo          , Wo          , Wo          , Wo          , Wo          , Wo          , Wo          , Wo          , Wo          , Ww          , Ww          , Ds          , Gg          , Gs^Fms      , Gs^Fms      , Gs^Fms      , Gg          , Gs^Fds      , Gs^Fds      , Gs^Fms      , Gg          , Gg          , Gs^Fms      , Gg          , Gs          , Gs          , Gg          , Gg          , Gg          
Wo          , Wo          , Wo          , Wo          , Wo          , Wo          , Wo          , Wo          , Wo          , Wo          , Wo          , Wo          , Wo          , Wo          , Wo          , Wo          , Wo          , Wo          , Wo          , Wo          , Wo          , Wo          , Wo          , Ww^Vm       , Ww          , Ds          , Ds          , Gg          , Gg          , Gg          , Gg          , Gg          , Gg          , Gg          , Gg          , Gg          , Gs^Fms      , Gs^Fms      , Gg^Vh       , Gs          , Gs^Fp       , Gg          , Gg          
Wo          , Wo          , Wo          , Wo          , Wo          , Wo          , Wo          , Wo          , Wo          , Wo          , Wo          , Wo          , Wo          , Wo          , Wo          , Wo          , Wo          , Wo          , Wo          , Wo          , Wo          , Wo          , Wo          , Wo          , Ww^Bw/      , Ds          , Ds          , Ch          , Gg          , Gg          , Ds          , Ds          , Ds          , Gg          , Gs          , Gs          , Gs          , Gs          , Gs          , Gg          , Gs^Fp       , Gg          , Gg          
Wo          , Wo          , Wo          , Wo          , Wo          , Wo          , Wo          , Wo          , Wo          , Wo          , Wo          , Wo          , Wo          , Wo          , Ww          , Wo          , Ww          , Wo          , Wo          , Wo          , Wo          , Wo          , Ww^Bw/      , Ww^Bw/      , Ww          , Ww          , Ds          , Ch          , Gg^Vh       , Gg          , Ch          , Gg          , Gg          , Gg          , Gs          , Gs^Fms      , Gs^Fms      , Gs          , Gs          , Gs^Fp       , Gs^Fp       , Gg          , Gg          
Wo          , Wo          , Wo          , Wo          , Wo          , Wo          , Wo          , Wo          , Wo          , Wo          , Wo          , Wo          , Ww          , Ww          , 2 Ww^Bw\    , Ww          , Gg^Vh       , Wo          , Wo          , Wo          , Ww^Bw/      , Ww^Bw/      , Ww          , Ww          , Ww          , Ww          , Ds          , Ch          , Ch          , Ch          , Ch          , Ch          , Ch          , Gg          , Gs          , Gs^Fms      , Gs^Fms      , Gs          , Gg          , Gs          , Gs          , Gg          , Gg          
Wo          , Wo          , Wo          , Wo          , Wo          , Wo          , Wo          , Wo          , Wo          , Wo          , Wo          , Wo          , Ww          , Ww          , Gg^Vh       , Gg          , Gg          , Ww          , Ww^Bw/      , Ww^Bw/      , Ww          , Ww          , Ww          , Ww          , Ww          , Ww          , Ww^Bw/      , Ds          , Ch          , Chr         , 3 Kh        , Ch          , Ch          , Gg          , Gs          , Gs^Fms      , Gg          , Gs          , Gs          , Gs          , Gs          , Gg          , Gg          
Wo          , Wo          , Wo          , Wo          , Wo          , Wo          , Wo          , Wo          , Wo          , Wo          , Wo          , Wo          , Ww^Vm       , 1 Ww^Bw\    , Gg          , Gg          , Gg          , Gg          , Ds          , Ww          , Ww          , Ww          , Ww          , Ww          , Wo^Bw/      , Ww^Bw/      , Ww          , Ds          , Ds          , Ch          , Ch          , Ch          , Rb          , Gs          , Gs          , Gg          , Gs^Fms      , Gs          , Gs          , Gg^Vh       , Gs          , Gg          , Gg          
Wo          , Wo          , Wo          , Wo          , Wo          , Wo          , Wo          , Wo          , Wo          , Wo          , Wo          , Wo          , Ww          , Gg          , Gg          , Gg          , Ch          , Ds          , Gg^Vh       , Ww          , Ww          , Ww          , Wo^Bw/      , Wo^Bw/      , Wo          , Wo          , Ww          , Ds          , Ds          , Ch          , Gs          , Gs          , Gg          , Rb          , Gs          , Gs^Fms      , Gs^Fms      , Gs          , Gs          , Gs          , Gs^Fp       , Gs          , Gg          
Wo          , Wo          , Wo          , Wo          , Wo          , Wo          , Wo          , Wo          , Wo          , Wo          , Wo          , Ww          , Ww          , Gg^Vh       , Ww          , Chr         , Kh          , Ch          , Gg^Vh       , Ds          , Ww^Bw/      , Wo^Bw/      , Wo          , Wo          , Wo          , Wo          , Wo          , Ww          , Wwf         , Ds          , Gg^Vh       , Gg          , Gg          , Rb          , Gg          , Gs          , Gg          , Gs          , Gg          , Gg          , Gs^Fp       , Gg          , Gg          
Wo          , Wo          , Wo          , Wo          , Wo          , Wo          , Wo          , Wo          , Wo          , Wo          , Wo          , Ww          , Ww^Vm       , Ww          , Gg^Vh       , Ch          , Ch          , Ch          , Ds          , Ds          , Wo          , Wo          , Wo          , Wo          , Wo          , Wo          , Wo          , Ww          , Ww          , Wwf         , Ww          , Ds          , Ds          , Rb          , Ds          , Gg          , Ds          , Gg          , Gg          , Gg          , Gg          , Gg          , Gg          
Wo          , Wo          , Wo          , Wo          , Wo          , Wo          , Wo          , Wo          , Wo          , Wo          , Wo          , Wo          , Wo          , Ww          , Ww^Bw/      , Gg^Vh       , Ds          , Gg^Vh       , Wwr         , Wwr         , Ww^Vm       , Wo          , Wo          , Wo          , Wo          , Wo          , Wo          , Ww          , Wwf         , Ww          , Ww          , Ww          , Ww          , Ww^Bw|      , Ww          , Ds          , Ww          , Ds          , Ds          , Ds          , Ds          , Ds          , Gg          
Wo          , Wo          , Wo          , Wo          , Wo          , Wo          , Wo          , Wo          , Wo          , Wo          , Wo          , Wo          , Wo          , Ww          , Ww          , Ds          , Ww          , Ds          , Wwf         , Wwr         , Wwr         , Wo          , Wo          , Wo          , Wo          , Wo          , Ww          , Ww          , Ds          , Ds          , Ds          , Ww          , Ww          , Ww^Bw|      , Ww          , Ww          , Ww^Vm       , Ww          , Ww          , Ds          , Ww          , Ds          , Ds          
Wo          , Wo          , Wo          , Wo          , Wo          , Wo          , Wo          , Wo          , Wo          , Wo          , Wo          , Wo          , Wo          , Ww          , Ww          , Ww          , Ww          , Wwf         , Wwf         , Wwf         , Wwr         , Wo          , Wo          , Wo          , Wo          , Wo          , Ww          , Wwf         , Gs          , Gs          , Gs          , Ds          , Ds          , Ww^Bw|      , Ds          , Ww          , Ww          , Ww          , Ww          , Ww          , Ww          , Ww          , Ww          
Wo          , Wo          , Wo          , Wo          , Wo          , Wo          , Wo          , Wo          , Wo          , Wo          , Wo          , Wo          , Wo          , Wo          , Ww          , Ww          , Ww          , Wwr         , Wwf         , Wwf         , Ww          , Wwr         , Ww          , Wo          , Wo          , Wo          , Ww          , Ds          , Gs          , Gg^Vh       , Gs          , Gs          , Re          , Re          , Gg          , Ds          , Ds          , Ww          , Ww          , Wo          , Ww          , Ww          , Ww          
Wo          , Wo          , Wo          , Wo          , Wo          , Wo          , Wo          , Wo          , Wo          , Wo          , Wo          , Wo          , Wo          , Wo          , Wo          , Ww          , Ww          , Ww          , Wwf         , Ww^Vm       , Ww          , Wwr         , Wwr         , Wo          , Wo          , Wo          , Ww          , Ds          , Gs          , Gs          , Gs^Fms      , Gs^Fms      , Re          , Gs          , Ds          , Gg          , Gg          , Ds          , Gg^Vh       , Ds          , Ds          , Ww          , Ww          
Wo          , Wo          , Wo          , Wo          , Wo          , Wo          , Wo          , Wo          , Wo          , Wo          , Wo          , Wo          , Wo          , Wo          , Wo          , Ww          , Ww          , Wwr         , Ww          , Wwf         , Wwf         , Wwr         , Ww          , Ww          , Wo          , Ww          , Ds          , Ds          , Gs          , Gs          , Gs          , Gs^Fms      , Re          , Ds          , Gg          , Gs^Fp       , Gs          , Gg          , Gg          , Gg          , Gg          , Gs^Fp       , Gs^Fp       
Wo          , Wo          , Wo          , Wo          , Wo          , Wo          , Wo          , Wo          , Wo          , Wo          , Wo          , Wo          , Wo          , Wo          , Wo          , Wo          , Ww          , Ww          , Ww          , Wwr         , Wwr         , Wwf         , Ww^Vm       , Ww          , Ww          , Ww          , Ds          , Ds          , Gs          , Re          , Re          , Gs          , Gs          , Gs          , Gg          , Gg          , Gg          , Gs          , Gs          , Gs          , Gg          , Gs^Fp       , Gg          
Wo          , Wo          , Wo          , Wo          , Wo          , Wo          , Wo          , Wo          , Wo          , Wo          , Wo          , Wo          , Wo          , Wo          , Wo          , Wo          , Ww          , Ww          , Ww          , Wwr         , Wwr         , Wwf         , Wwf         , Ww          , Ww          , Ww          , Ds          , Gg          , Gs          , Re          , Gs^Fms      , Gs^Fms      , Gg          , Gs          , Cv          , Cv          , Cv          , Gs          , Gs^Fp       , Gs          , Gg          , Gg          , Gg          
Wo          , Wo          , Wo          , Wo          , Wo          , Wo          , Wo          , Wo          , Wo          , Wo          , Wo          , Wo          , Wo          , Wo          , Wo          , Wo          , Ww          , Ww          , Ww          , Ww          , Ww          , Wwr         , Wwf         , Wwf         , Wwf         , Ds          , Ds          , Gg^Vh       , Gg          , Re          , Gs^Fms      , Gs^Fms      , Gg          , Gg          , Cv          , 4 Kv        , Cv          , Gg          , Gg          , Gs^Fp       , Gs^Fp       , Gg          , Gg          
Wo          , Wo          , Wo          , Wo          , Wo          , Wo          , Wo          , Wo          , Wo          , Wo          , Wo          , Wo          , Wo          , Wo          , Wo          , Wo          , Wo          , Ww          , Ww^Vm       , Ww          , Ww          , Wwr         , Wwr         , Wwf         , Ds          , Ds          , Ds          , Ds          , Gs          , Gs          , Gg          , Gs          , Gg          , Gs          , Gs          , Cv          , Gg          , Gs          , Gs          , Gs          , Gg          , Gg          , Gg          
Wo          , Wo          , Wo          , Wo          , Wo          , Wo          , Wo          , Wo          , Wo          , Wo          , Wo          , Wo          , Wo          , Wo          , Wo          , Wo          , Ww          , Ww          , Ww          , Ww          , Wwr         , Wwr         , Ww          , Ww          , Ds          , Ds          , Gs          , Ds          , Re          , Ds          , Gs          , Gs          , Gs          , Gs          , Gs          , Gg          , Gg          , Gg          , Gg^Vh       , Gs          , Gg          , Gg          , Gg          
Wo          , Wo          , Wo          , Wo          , Wo          , Wo          , Wo          , Wo          , Wo          , Wo          , Wo          , Wo          , Wo          , Wo          , Wo          , Wo          , Wo          , Ww          , Ww          , Ww          , Ww          , Wwr         , Ds          , Ds          , Gs          , Gs          , Gg          , Gs          , Re          , Gg          , Gg^Vh       , Gs^Fms      , Gs^Fms      , Gs          , Gs          , Gg          , Gs^Fp       , Gg          , Gg          , Gg          , Gg          , Gg          , Gg          
Wo          , Wo          , Wo          , Wo          , Wo          , Wo          , Wo          , Wo          , Wo          , Wo          , Wo          , Wo          , Wo          , Wo          , Wo          , Wo          , Wo          , Ww          , Ww          , Ww          , Ds          , Ds          , Gs          , Ds          , Gs          , Gg^Vh       , Re          , Gs          , Gs^Fms      , Gs          , Gg          , Gs^Fms      , Gg          , Gs          , Gs          , Gg          , Gg          , Gg          , Gg          , Gg          , Gg          , Gs^Fp       , Gg          
Wo          , Wo          , Wo          , Wo          , Wo          , Wo          , Wo          , Wo          , Wo          , Wo          , Ww          , Wo          , Ww          , Wo          , Ww          , Wo          , Ww          , Ww          , Ds          , Ds          , Gg          , Ds          , Gg          , Gs          , Gg          , Gg          , Re          , Gs^Fms      , Gs^Fms      , Gs^Fms      , Gs          , Gs          , Ds          , Ds          , Gs          , Gg          , Gs^Fms      , Gg          , Gg          , Gg          , Gg          , Gs^Fp       , Gg          
Ww          , Ww          , Ww          , Wo          , Wo          , Wo          , Ww          , Wo          , Ww          , Wo          , Ww          , Ww^Vm       , Ww          , Wo          , Ww          , Ww          , Ds          , Ds          , Gg          , Ds          , Gg          , Gg          , Gg          , Gs^Fms      , Gs^Fms      , Gs          , Gg          , Gs          , Gg          , Gs          , Gs          , Gs          , Gg          , Ds          , Gg          , Gs          , Gs^Fms      , Gs^Fms      , Gg          , Gg^Vh       , Gg          , Gg          , Gg          
Ww          , Ww          , Ww          , Wo          , Wo          , Wo          , Ww          , Ww          , Ww          , Wo          , Ww          , Ww          , Ds          , Ww          , Ds          , Ds          , Ds          , Ds          , Gg          , Gg          , Gg^Vh       , Gg          , Re          , Gs^Fms      , Gg          , Gs          , Gg          , Gg          , Gg          , Gs          , Gs          , Hh          , Hh          , Hh          , Gs          , Gs          , Gg          , Gg          , Gs          , Gg          , Gs          , Gg          , Gg          
Ds          , Ds          , Ds          , Ww          , Ww          , Wo          , Ww          , Ww^Vm       , Ww          , Ww          , Ds          , Ww          , Ds          , Ds          , Gg          , Ds          , Gg          , Gg          , Ds          , Ds          , Re          , Re          , Gg          , Gg          , Gs^Fms      , Gg          , Gs^Fms      , Gs^Fms      , Gg          , Gs          , Hh          , Hh          , Hh          , Hh          , Gg          , Gs          , Gg^Vh       , Gs          , Gs          , Gs^Fp       , Gs^Fp       , Gg          , Gg          
Gg          , Gg          , Gs^Fms      , Ds          , Ds          , Ww          , Ww          , Ww          , Ds          , Ds          , Gg          , Ds          , Gg          , Gg          , Gs^Fms      , Gg          , Re          , Re          , Re          , Re          , Gg          , Gg          , Gg          , Gs^Fms      , Gs^Fms      , Gg          , Gg          , Gs^Fms      , Gs          , Gs          , Hh          , Hh          , Hh          , Hh          , Gg          , Gg          , Gg          , Gg          , Gg          , Gs^Fp       , Gg          , Gs^Fp       , Gg          
Gg          , Gs^Fms      , Ggf         , Gg          , Gg          , Ds          , Ds          , Ds          , Gg          , Ds          , Gg^Vh       , Gg          , Gs^Fms      , Gs^Fms      , Re          , Re          , Gg^Vh       , Gg          , Gs^Fms      , Gg          , Gg          , Gg          , Gg          , Gs^Fms      , Gg          , Gg          , Gg          , Gg          , Gs          , Gs          , Hh          , Hh          , Hh^Fms      , Hh^Fms      , Hh^Fp       , Gg          , Gg          , Gg          , Gg          , Gg          , Gg          , Gg          , Gg          
Gg          , Gs^Fp       , Gg          , Gg          , Gg          , Gs^Vht      , Gs^Fms      , Gs^Fms      , Gg          , Gg          , Rr          , Gg          , Rr          , Re          , Gg          , Gg          , Gg          , Gs^Fms      , Gs^Fms      , Gs^Fms      , Gg          , Gg          , Gg          , Gg          , Gg          , Gg^Vh       , Gg          , Gg          , Hh          , Hh          , Hh          , Hh          , Hh          , Hh^Fms      , Hh^Fp       , Hh^Fp       , Hh^Fds      , Hh^Fds      , Gs^Fds      , Gg          , Gg          , Gg          , Gg          
Gg          , Gs^Fp       , Re          , Gs^Fms      , Gs^Fms      , Gg          , Re          , Gs^Fms      , Re          , Re          , Re          , Re          , Gg          , Gg          , Gg          , Gg          , Gg          , Gg          , Gg          , Gg          , Gg^Vh       , Gg          , Gg          , Gg          , Hh          , Gg          , Hh          , Hh          , Hh          , Hh^Fds      , Hh^Fds      , Hh^Fms      , Hh^Fms      , Hh^Fms      , Gs^Fds      , Hh^Fp       , Hh^Fp       , Gs^Fds      , Gs^Fmf      , Gs^Fp       , Gs^Fp       , Gg          , Gg          
Gg          , Re          , Gs^Fp       , Gs^Fms      , Gs^Fms      , Re          , Gs^Fms      , Re          , Gs^Fms      , Re          , Gg          , Gg          , Gg          , Gs^Fp       , Gg          , Gs^Fp       , Gg          , Gs^Fp       , Gg          , Gg          , Gs          , Gs          , Gs          , Gs          , Hh^Fds      , Hh          , Hh          , Hh          , Hh^Fms      , Hh          , Hh^Fds      , Hh^Fds      , Hh^Fds      , Hh^Fds      , Hh^Fds      , Hh^Fp       , Hh^Fp       , Gs^Fmf      , Gs^Fmf      , Gs^Fp       , Gg          , Gg          , Gg          
Gg          , Gg          , Gg          , Gg          , Gg          , Gg          , Gg          , Gs^Fms      , Gg          , Gs^Fms      , Gg          , Gs^Fms      , Gg          , Gg          , Gg          , Gg          , Gg          , Gg          , Gg          , Gg          , Gs^Fp       , Gs^Fp       , Gs          , Hh^Fds      , Hh^Fms      , Hh^Fms      , Hh          , Hh          , Hh^Fms      , Hh^Fms      , Hh^Fms      , Hh^Fds      , Hh^Fds      , Hh^Fds      , Hh^Fds      , Hh^Fp       , Gg          , Hh^Fds      , Gg          , Gg          , Gg          , Gg          , Gg          
