border_size=1
usage=map

Gs^Fp       , Gs^Fp       , Gs^Fp       , Gs^Fp       , Gs^Fp       , Gs^Fp       , Gs^Fp       , Gg          , Gg          , Re          , Gg          , Gg          , Gg          , Gg          , Gg          , Gs^Fms      , Gs^Fms      , Mm          , Gs^Fms      , Gs^Fms      , Gs^Fds      , Gs^Fds      , Gs^Fds      , Gg          , Gg          , Gg          , Gg          
Gs^Fp       , Gs^Fp       , Gs^Fp       , Gs^Fp       , Gg          , Gs^Fp       , Gs^Fp       , Gg          , Re          , Re          , Gg          , Gg          , Gg          , Gg          , Gg          , Gs^Fms      , Gs^Fms      , Ww          , Gs^Fms      , Gs^Fms      , Gs^Fms      , Gs^Fds      , Gs^Fds      , Gs^Fds      , Gs^Fds      , Gg          , Gg          
Gs^Fp       , Gs^Fp       , Gs^Fp       , Gs^Fp       , Gs^Fp       , Gs^Fp       , Re          , Re          , Gg          , Re          , Gg          , Gg          , Gg          , Gg          , Gg          , Gs^Fms      , Gs^Fms      , Ww          , Ww          , Gs^Fms      , Ww          , Ww          , Ww          , Ww          , Ww          , Ww          , Ww          
Gs^Fp       , Gs^Fp       , Re          , Re          , Re          , Re          , Gs^Fp       , Gs^Fp       , Gs^Fp       , Re          , Gs^Fp       , Gg          , Gs^Fms      , Gs^Fms      , Gs^Fms      , Gs^Fms      , Gs^Fds      , Gs^Fds      , Ww          , Ww          , Gs^Fds      , Ww          , Hh          , Hh          , Hh          , Ww          , Gg          
Gs^Fp       , Re          , Gs^Fp       , Gs^Fp       , Gs^Fp       , Gs^Fp       , Gs^Fp       , Gs^Fp       , Gs^Fp       , Re          , Gs^Fp       , Gs^Fp       , Gg          , Gg          , Gs^Fms      , Gs^Fms      , Gs^Fds      , Gg^Vh       , Ss          , Gs^Fds      , Ss          , Gs^Fds      , Gs^Fds      , Mm          , Hh          , Hh          , Gs^Fds      
Gs^Fp       , Re          , Gs^Fp       , Gs^Fp       , Gs^Fp       , Gs^Fp       , Gs^Fp       , Gs^Fp       , Gs^Fp       , Re          , Gs^Fp       , Gg          , Gs^Fms      , Gg          , Gs^Fms      , Gs^Fms      , Gs^Fds      , Ss          , Ss          , Ss          , Gs^Fds      , Ss          , Ss          , Gg          , Gs^Fds      , Gs^Fds      , Gg          
Re          , Re          , Gs^Fp       , Gs^Fp       , Gs^Fp       , Gs^Fp       , Gs^Fp       , Gs^Fp       , Mm^Xm       , Re          , Mm^Xm       , Mm          , Mm^Xm       , Mm^Xm       , Mm^Xm       , Gs^Fds      , Ss          , Ss          , Ss          , Gs^Fds      , Gs^Fds      , Gg          , Ss          , Gg          , Gs^Fds      , Gg          , Gg          
Hh          , Hh^Fp       , Hh^Fp       , Hh^Fp       , Hh^Fp       , Gs^Fp       , Mm^Xm       , Mm^Xm       , Mm          , Mm^Xm       , Mm          , Mm^Xm       , Re          , Mm          , Mm^Xm       , Mm^Xm       , Mm^Xm       , Mm^Xm       , Mm          , Ss          , Ss          , Ss          , Gs^Fds      , Gg          , Gs^Fds      , Gg          , Gg          
Mm          , Hh          , Mm^Xm       , Hh          , Mm^Xm       , Mm^Xm       , Mm^Xm       , Mm^Xm       , Mm          , Mm          , Gs^Fp       , Re          , Re          , Re          , Gs^Fms      , Mm^Xm       , Mm          , Mm^Xm       , Mm          , Mm^Xm       , Mm^Xm       , Gg          , Gs^Fds      , Gs^Fds      , Gg          , Gg          , Gg          
Mm^Xm       , Mm          , Mm^Xm       , Mm^Xm       , Hh          , Mm          , Gg          , Gs^Fp       , Gs^Fp       , Gg          , Gg          , Gs^Fms      , Gs^Fms      , Re          , Gs^Fms      , Gg          , Gs^Fms      , Gg          , Ss          , Mm          , Mm^Xm       , Mm^Xm       , Mm^Xm       , Gg          , Cud         , Gg          , Cud         
Mm^Xm       , Mm^Xm       , Mm^Xm       , Mm^Xm       , Mm          , Hh          , Hh^Fp       , Gs^Fp       , Gs^Fp       , Gs^Fp       , Gg          , Gg          , Re          , Re          , Gs^Fms      , Gs^Fms      , Ss          , Ss          , Ss          , Ss          , Ss          , Mm^Xm       , Mm^Xm       , Cud         , Kud         , Cud         , Kud         
Mm          , Mm^Xm       , Mm^Xm       , Mm          , Mm          , Hh          , Hh          , Hh^Fp       , Gs^Fp       , Gs^Fp       , Gs^Fp       , Re          , Gs^Fp       , Re          , Gs^Fms      , Gs^Fms      , Gs^Fms      , Ss          , Ss          , Ss          , Ss          , Mm^Xm       , Mm^Xm       , Kud         , Gg          , Kud         , Gg          
Mm          , Mm          , Mm          , Hh          , Hh          , Hh          , Hh^Fp       , Gs^Fp       , Gs^Fp       , Gs^Fp       , Gg^Vh       , Gs^Fp       , Re          , Re          , Gs^Fp       , Gs^Fms      , Gs^Fms      , Gs^Fds      , Gs^Fds      , Ss          , Mm^Xm       , Mm^Xm       , Mm^Xm       , Gg          , Gg          , Gg          , Gg          
Hh          , Mm          , Hh          , Hh^Fp       , Gs^Fp       , Hh^Fp       , Hh^Fp       , Gs^Fp       , Gs^Fp       , Gs^Fp       , Gg          , Gs^Fp       , Re          , Re          , Re          , Re          , Gs^Fms      , Gs^Fds      , Gs^Fds      , Gs^Fds      , Mm^Xm       , Mm^Xm       , Gg          , Gg          , Gg          , Gg          , Gg          
Ww          , Hh          , Ww          , Ww          , Ww          , Gs^Fp       , Gs^Fp       , Gs^Fp       , Re          , Gs^Fp       , Re          , Re          , Gg          , Gs^Fp       , Re          , Gs^Fp       , Gs^Fms      , Gs^Fms      , Ww          , Ww          , Mm          , Mm^Xm       , Rp^Vhc      , Gg          , Rp^Vhc      , Gg          , Gg          
Ww          , Ww          , Ww          , Ww          , Gg          , Gs^Fp       , Gs^Fp       , Re          , Gs^Fp       , Gg          , Re          , Gs^Fp       , Gg          , Re          , Gs^Fp       , Gs^Fp       , Ww          , Ww          , Ch          , Mm          , Rd          , Mm          , Mm          , Ch          , Ch          , Gg          , Gg          
Ww          , Ww          , Ww          , Gg          , Gs^Fms      , Gs^Fp       , Gs^Fp       , Gs^Fp       , Gs^Fp       , Gg          , Re          , Re          , Gs^Fp       , Gs^Fp       , Re          , Gs^Fp       , Ww          , Ch          , Kh          , Kh          , Rd          , Mm          , Ch          , Ch          , Ch          , Kh          , Gg          
Gs^Fms      , Ww          , Gg^Ve       , Gs^Fms      , Gs^Fms      , Gs^Fp       , Gs^Fp       , Gs^Fp       , Gs^Fp       , Re          , Re          , Gg          , Gs^Fp       , Gs^Fp       , Gs^Fp       , Gs^Fp       , Ww          , Ch          , Kh          , Rd          , Rd          , Ch          , Ch          , 2 Kh        , Ch          , Ch          , Gg          
Gs^Fms      , Gs^Fms      , Gs^Fms      , Gs^Fms      , Gs^Fms      , Gs^Fp       , Gs^Fms      , Gs^Fms      , Gg          , Gg          , Re          , Gg          , Gg^Vh       , Gs^Fp       , Gs^Fp       , Gs^Fp       , Ww          , Ch          , Ww          , Ww          , Ww          , Kh          , Ch          , Ch          , Kh          , Ch          , Gg          
Gs^Fms      , Gs^Fms      , Gs^Fms      , Gs^Fms      , Gg          , Gs^Fms      , Gs^Fms      , Gs^Fms      , Re          , Re          , Re          , Gs^Fp       , Gg          , Gs^Fp       , Gs^Fms      , Gs^Fms      , Ww          , Ch          , Ww          , Mm          , Mm^Xm       , Ww          , Ww          , Ch          , Ch          , Ch          , Gg          
Gs^Fms      , Gs^Fms      , Gs^Fms      , Gg          , Gs^Fms      , Gs^Fms      , Re          , Gs^Fms      , Gg          , Gs^Fms      , Gg          , Re          , Re          , Gg          , Re          , Gs^Fms      , Hh          , Ww          , Mm^Xm       , Mm^Xm       , Mm^Xm       , Ch          , Ch          , Ww          , Gg          , Rp^Vhc      , Gg          
Gs^Fms      , Gs^Fms      , Gg^Fet      , Gs^Fms      , Gs^Fms      , Gs^Fms      , Re          , Gs^Fms      , Gs^Fms      , Gs^Fms      , Gg^Ve       , Gg          , Re          , Re          , Gs^Fms      , Hh          , Mm          , Mm          , Mm          , Mm^Xm       , Mm          , Rp^Vhc      , Gg          , Ww          , Gg          , Gg          , Gg          
Gs^Fms      , Gs^Fms      , Gs^Fms      , Gs^Fms      , Ch          , Ch          , Ch          , Gs^Fms      , Gs^Fms      , Gs^Fms      , Gs^Fms      , Gs^Fms      , Re          , Gg          , Gs^Fms      , Re          , Gs^Fds      , Mm          , Mm          , Mm          , Kh          , Gg          , Gg          , Ww          , Gg          , Gg          , Gg          
Gs^Fms      , Gs^Fms      , Gs^Fms      , Gs^Fms      , Ch          , 3 Kh        , Ch          , Gs^Fms      , Gs^Fms      , Gs^Fms      , Gs^Fms      , Gg          , Rd          , Gg          , Gs^Fms      , Gs^Fds      , Gg          , Re          , Ww          , Ch          , Ch          , Kh          , Ww          , Ww          , Kh          , Kh          , Kh          
Gs^Fms      , Gs^Fms      , Gs^Fms      , Gg          , Gg          , Ch          , Gs^Fms      , Gs^Fms      , Gs^Fms      , Gs^Fms      , Rd          , Rd          , Gs^Fms      , Gg          , Hh          , Gg          , Hh^Fds      , Hh^Fds      , Hh^Fds      , Ww          , Ww          , Ww          , Ch          , Ch          , Ch          , Ch          , Ch          
Gs^Fms      , Gs^Fms      , Gs^Fms      , Gs^Fms      , Gs^Fms      , Gs^Fms      , Gg          , Gs^Fms      , Gs^Fms      , Gs^Fms      , Gg          , Rd          , Rd          , Hh          , Gs^Fms      , Hh          , Hh          , Hh          , Hh          , Gg          , Gs^Fds      , Ww          , Ww          , Ww          , Ww          , Ww          , Ww          
Ww          , Wwf         , Wwf         , Gg          , Ww          , Ww          , Gs^Fms      , Gs^Fms      , Gs^Fms      , Gg          , Gs^Fms      , Re          , Gg          , Gg          , Gs^Fds      , Hh^Fds      , Hh^Fds      , Hh          , Hh          , Hh^Fds      , Gs^Fds      , Ww          , Gg          , Gg          , Gg          , Gg          , Gg          
Re          , Re          , Gs^Fms      , Ww          , Ww          , Ww          , Ww          , Gg          , Ww          , Ww          , Ww          , Re          , Wwf         , Gg          , Ww          , Gs^Fds      , Ww          , Ww          , Ww          , Ww          , Ww          , Ww          , Gg          , Gg          , Gs^Fms      , Gg          , Gs^Fms      
Hh          , Rd          , Re          , Ww          , Gs^Fms      , Ww          , Gs^Fms      , Ww          , Gs^Fms      , Gs^Fms      , Gs^Fms      , Wwf         , Gg          , Ww          , Gs^Fds      , Ww          , Gs^Fds      , Gs^Fds      , Ww          , Ww          , Gg          , Gg          , Gs^Fms      , Gs^Fms      , Gs^Fms      , Gs^Fms      , Gs^Fms      
Hh^Fms      , Hh          , Re          , Hh          , Hh          , Gs^Fms      , Gs^Fms      , Gs^Fms      , Gs^Fms      , Gg^Ve       , Rd          , Rd          , Gs^Fms      , Gg          , Gs^Fds      , Gs^Fds      , Gs^Fms      , Ww          , Gs^Fds      , Ww          , Gg          , Gs^Fms      , Gs^Fms      , Gg          , Gs^Fms      , Gs^Fms      , Gg          
Hh^Fms      , Hh^Fms      , Hh^Fms      , Hh          , Gs^Fms      , Gg          , Gs^Fms      , Gs^Fms      , Gs^Fms      , Gs^Fms      , Gg          , Rd          , Rd          , Gg^Ve       , Gg          , Gs^Fms      , Gs^Fms      , Gs^Fds      , Gs^Fms      , Gg          , Gg          , Gs^Fms      , Gs^Fms      , Gs^Fms      , Gg          , Gg          , Gg          
Hh          , Hh          , Gs^Fms      , Gg          , Gs^Fms      , Gs^Fms      , Gs^Fms      , Gg          , Gg          , Gs^Fms      , Gg^Vh       , Rd          , Gs^Fms      , Gs^Fms      , Gs^Fms      , Gs^Fms      , Gg          , Gs^Fms      , Gs^Fms      , Gs^Fms      , Gs^Fms      , Gs^Fds      , Gs^Fds      , Gs^Fmf      , Gs^Fmf      , Gg          , Gg          
Gs^Fms      , Gs^Fms      , Gs^Fms      , Gs^Fms      , Re          , Re          , Gs^Fms      , Gg          , Gg          , Gs^Fms      , Gs^Fms      , Rd          , Gs^Fms      , Gs^Fms      , Gg          , Gs^Fms      , Gg          , Gg          , Gs^Fms      , Gs^Fms      , Gs^Fms      , Gs^Fds      , Gs^Fds      , Gs^Fmf      , Gs^Fmf      , Gg          , Gs          
Re          , Gs^Fms      , Gg          , Re          , Gg          , Re          , Gg          , Gg          , Gs^Fms      , Gs^Fms      , Gs^Fms      , Rd          , Gs^Fms      , Gg^Vh       , Gs^Fms      , Gg          , Gs^Fms      , Gs^Fms      , Gs^Fms      , Gs^Fms      , Gs^Fds      , Gs^Fds      , Gs^Fmf      , Hh          , Hh          , Gs          , Gs          
Gs^Fms      , Re          , Re          , Gg          , Gg          , Gs^Fms      , Chr         , Gs^Fms      , Gg          , Gg          , Gg          , Rd          , Gg          , Gs^Fms      , Gs^Fms      , Gs^Fms      , Hh          , Hh          , Hh^Fms      , Hh^Fms      , Gs^Fms      , Gg          , Gg          , Gs^Fms      , Gg^Wm       , Gs          , Gg          
Gs^Fms      , Gs^Fms      , Gs^Fms      , Gs^Fms      , Gs^Fms      , Chr         , Gs^Fms      , Gg          , Gg          , Gs^Fms      , Rd          , Rd          , Re          , Gg          , Gg          , Gs^Fms      , Gs^Fms      , Hh          , Gs^Fms      , Hh^Fms      , Gs^Fms      , Gs^Fmf      , Gs^Fmf      , Gs^Fms      , Gs^Fms      , Gs          , Gg          
Gs^Fms      , Gs^Fms      , Gs^Fms      , Re          , Gs^Fms      , Chr         , Gg          , Chr         , Gg          , Gs^Fms      , Rd          , Gs^Fms      , Gg          , Re          , Re          , Gs^Fms      , Gs^Fms      , Gs^Fms      , Gs^Fms      , Gg^Vh       , Gg          , Gg          , Gs^Fp       , Gs^Fms      , Gs^Fms      , Gs^Fms      , Gg          
Gs^Fms      , Gs^Fms      , Gg          , Gg          , Gg          , Gg          , Gg          , Gs^Fms      , Re          , Rd          , Gs^Fms      , Gg          , Gs^Fms      , Gs^Fms      , Gs^Fms      , Re          , Re          , Gs^Fms      , Gs^Fms      , Gs^Fms      , Gs^Fms      , Gs^Fp       , Gs^Fp       , Gs^Fms      , Gg          , Gs^Fms      , Gg          
Gs^Fms      , Gs^Fms      , Gs^Fms      , Gg^Ve       , Gs^Fms      , Gg          , Rd          , Rd          , Gg          , Gs^Fms      , Gs^Fms      , Gg          , Gs^Fms      , Gg^Ve       , Gs^Fms      , Gs^Fms      , Re          , Gg          , Gs^Fms      , Gs^Fms      , Gs^Fms      , Gs^Fp       , Gs^Fms      , Gs^Fms      , Gg          , Gs^Fms      , Gg          
Gs^Fms      , Gs^Fms      , Gs^Fms      , Gs^Fms      , Gs^Fms      , Gs^Fms      , Rd          , Gg          , Gg          , Gs^Fms      , Gg          , Gs^Fms      , Gg          , Gs^Fms      , Gg          , Gs^Fms      , Re          , Gs^Fms      , Gs^Fms      , Gs^Fms      , Gs^Fms      , Gg          , Hh          , Gs^Fms      , Gs^Fms      , Gs^Fms      , Gs^Fms      
Gs^Fms      , Gs^Fms      , Gs^Fms      , Gg          , Gg          , Re          , Rd          , Gg          , Gg^Vh       , Gg          , Gs^Fms      , Gs^Fms      , Gs^Fms      , Gg          , Gg          , Gg          , Gs^Fms      , Re          , Re          , Re          , Re          , Gg          , Hh          , Gs^Fms      , Gs^Fms      , Gs^Fms      , Gg          
Gs^Fms      , Gs^Fms      , Gs^Fms      , Gs^Fms      , Gg          , Gg          , Gs^Fms      , Rd          , Rd          , Gs^Fms      , Gs^Fms      , Gg          , Gs^Fms      , Gg          , Gs^Fms      , Gg          , Gs^Fms      , Gs^Fms      , Gs^Fms      , Gg          , Gg          , Re          , Re          , Hh          , Gs^Fms      , Gg          , Gg          
Gs^Fms      , Gs^Fms      , Gs^Fms      , Gs^Fms      , Gs^Fms      , Gg          , Rd          , Rd          , Gs^Fms      , Gg          , Gs^Fms      , Gs^Fms      , Gg          , Gg          , Gg          , Gg          , Gg          , Gs^Fms      , Gs^Fms      , Gg          , Gs^Fms      , Gg          , Gg          , Gs^Fms      , Re          , Gs^Fms      , Gg          
Gg          , Gs^Fms      , Gg          , Gg          , Rd          , Rd          , Gs^Fms      , Gg          , Gs^Fms      , Gg          , Gg          , Gg          , Gs^Fms      , Gs^Fms      , Gs^Fms      , Gg          , Gs^Fms      , Gs^Fms      , Gs^Fms      , Gs^Fms      , Gs^Fms      , Gg          , Gs^Fms      , Re          , Re          , Gg          , Re          
Gg          , Gg          , Gg          , Gs^Fms      , Gg          , Rd          , Rd          , Gg          , Gg          , Gg          , Gg          , Gs^Fms      , Re          , Gg          , Gs^Fms      , Gs^Fms      , Gg          , Gg          , Gg          , Gs^Fms      , Gs^Fms      , Gs^Fms      , Gs^Fms      , Gg          , Gg          , Re          , Gg          
Gg          , Gg          , Gg          , Gs^Fms      , Gg          , Gs^Fms      , Gs^Fms      , Rd          , Gs^Fms      , Gs^Fms      , Gs^Fms      , Re          , Gs^Fms      , Gs^Fms      , Gg          , Gs^Fms      , Gs^Fms      , Gg          , Gs^Fms      , Gs^Fms      , Gs^Fms      , Gs^Fms      , Gs^Fms      , Gg          , Gs^Fms      , Gg          , Gg          
Gs^Fms      , Gs^Fms      , Gs^Fms      , Gs^Fms      , Gg          , Gg          , Gs^Fms      , Rd          , Gs^Fms      , Gg          , Gg          , Gs^Fms      , Gg^Vh       , Gg          , Gg          , Gs^Fms      , Gg          , Gs^Fms      , Gg          , Gg          , Gs^Fms      , Gs^Fms      , Gs^Fms      , Gs^Fms      , Gs^Fms      , Gs^Fms      , Gg          
Gs^Fms      , Gs^Fms      , Gs^Fms      , Gg^Vh       , Gs^Fms      , Gs^Fms      , Rd          , Rd          , Rd          , Rd          , Rd          , Gs^Fms      , Gs^Fms      , Gs^Fms      , Gs^Fms      , Gs^Fms      , Rd          , Gs^Fms      , Rd          , Gs^Fms      , Gs^Fms      , Gs^Fms      , Gg          , Gs^Fms      , Gg          , Gs^Fms      , Gs^Fms      
Gg          , Gs^Fms      , Gg          , Gs^Fms      , Rd          , Rd          , Gg          , Gg          , Gg          , Gg          , Gg          , Gg          , Rd          , Gg          , Rd          , Gs^Fms      , Gs^Fms      , Rd          , Gs^Fms      , Rd          , Rd          , Gg          , Rd          , Gg          , Gg          , Gs^Fms      , Gg          
Rd          , Rd          , Rd          , Rd          , Gg          , Gg          , Gg          , Gg          , Ce          , Ce          , Ce          , Gg          , Gg          , Rd          , Gg          , Gg          , Gg          , Gs^Fms      , Gg          , Gg          , Gg          , Rd          , Gg          , Rd          , Gs^Fms      , Gs^Fms      , Gg          
Gg          , Gs^Fms      , Gg          , Rd          , Gg          , Gg          , Gg          , Ce          , Ce          , 1 Ke        , Ce          , Ce          , Gg          , Gg          , Gg          , Gg          , Gs^Fds      , Gs^Fds      , Hh          , Hh          , Hh          , Hh^Fp       , Hh^Fp       , Gg          , Gg          , Rd          , Gg          
Gg          , Gg          , Gg          , Gg          , Gg          , Gg          , Gg          , Gg          , Gg          , Ce          , Gg          , Gg          , Gg          , Gg          , Gg          , Gg          , Gg^Vh       , Hh^Fds      , Hh^Fds      , Mm          , Hh          , Hh^Fp       , Hh^Fp       , Gg          , Rd          , Rd          , Gg          
Ww          , Ww          , Ww          , Gs^Fds      , Gs^Fds      , Gs^Fds      , Gs^Fds      , Gg          , Gg          , Gg          , Gg          , Gg          , Gg          , Gg          , Gg          , Gs^Fds      , Gs^Fds      , Hh^Fds      , Hh^Fds      , Hh          , Gs^Fds      , Gs^Fms      , Gs^Fms      , Gg          , Gs^Fms      , Gg          , Gg          
Ww          , Ww          , Ww          , Ww          , Gs^Fds      , Gs^Fds      , Gs^Fds      , Gg          , Gg          , Gg          , Gg          , Gg          , Gg          , Gg          , Gg          , Gg          , Gg          , Gs^Fds      , Gs^Fds      , Gs^Fds      , Gs^Fms      , Gs^Fms      , Gs^Fms      , Gs^Fms      , Gs^Fms      , Gg          , Gg          
Ww          , Ww          , Ww          , Gs^Fds      , Gs^Fds      , Gs^Fds      , Gs^Fds      , Gg          , Gg          , Gg          , Gg          , Gg          , Gg          , Gg          , Gg          , Gg          , Gg          , Gg          , Gs^Fds      , Gs^Fds      , Gs^Fds      , Gs^Fms      , Gg          , Gg          , Gg          , Gg          , Gg          
