border_size=1
usage=map

Gs^Fp       , Gs^Fp       , Ss          , Gs^Fp       , Gs^Fms      , Gs^Fms      , Gs          , Hh          , Hh          , Mm          , Hh^Fms      , Hh^Fms      , Hh^Fms      , Hh^Fms      , Hh^Fms      , Hh^Fms      , Hh^Fms      , Mm          , Mm          , Mm          , Mm          , Mm          , Mm          , Mm          , Mm          , Mm          , Mm          , Gg          , Gg          , Gg          , Gg          , Gg          , Gs          , Gg          , Gg          , Gg          
Gs^Fp       , Gs^Fp       , Ss          , Gs^Fp       , Gs^Fp       , Gs^Fms      , Gs          , Hh          , Hh          , Mm          , Mm          , Hh^Fms      , Hh^Fms      , Hh^Fms      , Hh          , Hh^Fms      , Hh^Fms      , Hh^Fms      , Hh^Fms      , Mm          , Hh^Fmf      , Mm          , Hh          , Mm          , Hh^Fms      , Hh          , Hh          , Gg          , Gg          , Gs          , Gs          , Gs          , Gs          , Gg          , Gg          , Gg          
Gs^Fms      , Gs^Fp       , Ss          , Ss          , Gs^Fms      , Gs^Fms      , Gs          , Gs          , Gs          , Hh          , Gs          , Mm          , Hh^Fms      , Hh^Fms      , Hh          , Hh          , Hh^Fms      , Hh^Fms      , Hh^Fmf      , Hh^Fmf      , Hh^Fmw      , Hh^Fmf      , Hh^Fmw      , Hh          , Mm          , Hh          , Hh          , Gg          , Gg          , Gs          , Gs          , Gs          , Gs          , Gg          , Gg          , Gg          
Gs^Fp       , Gs^Fp       , Gs^Fms      , Gs^Fms      , Gs          , Gs^Fms      , Gs          , Gs^Fms      , Gg^Vh       , Gs          , Hh          , Rd          , Rd          , Hh^Fms      , Hh^Fms      , Hh          , Hh^Fmw      , Hh^Fmw      , Hh^Fms      , Hh^Fmf      , Hh^Fmw      , Hh^Fmw      , Hh^Fmw      , Hh^Fmw      , Mm          , Mm          , Mm          , Gg          , Gg          , Gs          , Gg          , Gg          , Gg          , Gs          , Gg          , Gg          
Gs^Fms      , Gs^Fms      , Gs^Fms      , Gs          , Gs^Fms      , Gs          , Gs^Fms      , Gs^Fms      , Hh^Fp       , Hh          , Hh^Fms      , Hh          , Hh          , Hh^Fms      , Hh^Fms      , Hh^Fms      , Hh^Fms      , Hh^Fms      , Hh^Fms      , Hh^Fmf      , Hh^Fmf      , Hh^Fmf      , Hh^Fmw      , Mm          , Mm          , Mm          , Mm          , Gg          , Gg          , Gg          , Gs^Fms      , Gg          , Gs^Fms      , Gg          , Gg          , Gg          
Gs          , Gs          , Gs          , Gs          , Gs^Fms      , Gs^Fms      , Gs^Fms      , Hh^Fms      , Gs^Fms      , Hh^Fms      , Hh^Fms      , Hh^Fms      , Hh^Fms      , Hh^Fms      , Hh^Fms      , Hh^Fms      , Hh^Fms      , Hh^Fms      , Hh^Fms      , Hh^Fms      , Mm          , Hh^Fmw      , Mm          , Mm          , Hh^Vhh      , Hh          , Hh          , Gg          , Gg          , Gg          , Gs^Fms      , Gs^Fms      , Gs^Fms      , Gs^Fms      , Gg          , Gg          
Gs          , Gs          , Gg          , Gg          , Gs^Fms      , Gs^Fms      , Gs^Fms      , Gs^Fms      , Gs          , Gs          , Hh          , Hh^Fms      , Mm          , Hh^Fms      , Mm          , Hh^Fms      , Hh          , Rd          , Rd          , Hh          , Hh          , Mm          , Mm          , Mm          , Hh          , Gs          , Gs          , Gg          , Gg          , Gg          , Gg          , Gg          , Gg          , Gg          , Gg          , Gg          
Gs          , Gs          , Gs          , Gg^Vh       , Gg          , Gs^Fms      , Gg          , Gs^Fms      , Gs          , Hh          , Hh          , Mm          , Hh          , Mm          , Hh          , Mm          , Hh          , Rd          , Gs          , Gs          , Gs          , Hh          , Hh          , Hh          , Hh          , Gs          , Gs          , Gs          , Gs          , Gg          , Gg          , Gg          , Gg          , Gg          , Gg          , Gg          
Ss          , Ss          , Gs          , Gg          , Re^Gvs      , Gg          , Gg          , Gg          , Gg          , Gg          , Hh          , Hh          , Hh          , Hh          , Gs          , Hh          , Gs          , Gs          , Gs          , Rd          , Gs          , Gs          , Gs          , Gs          , Gs          , Gs          , Gs          , Gs          , Gs          , Gg          , Gs          , Gg          , Gg          , Gg          , Gg          , Gg          
Gs          , Gs          , Gg^Vh       , Gg          , Gg          , Re^Gvs      , Re^Gvs      , Gg          , Gg          , Gs          , Gs          , Gs          , Gs          , Gs          , Gs          , Gs          , Gs          , Gs          , Gs          , Gs          , Rd          , Gs          , Gs          , Gs          , Gs^Fms      , Gs^Fp       , Gs^Fms      , Gg          , Gg          , Gg          , Gs          , Gs          , Gs          , Gs          , Gg          , Gg          
Gg          , Gg          , Gg          , Gg          , Gg^Vh       , Gg          , Gg          , Gg          , Gs^Fp       , Gs^Fp       , Gs^Fp       , Gg          , Gg          , Gg          , Gg          , Gs          , Gs^Fms      , Gs^Vht      , Gs^Fms      , Gs          , Gs          , Gs          , Gs          , Gg          , Gs^Fp       , Gs^Fms      , Gs^Fp       , Gs^Fp       , Gs^Fms      , Gg          , Gg          , Gg          , Gs^Fms      , Gg          , Gg          , Gg          
Ww          , Ww          , Ds          , Gg          , Gg          , Gg          , Gg          , Gs^Fms      , Gs^Fp       , Ss          , Gs^Fms      , Gg          , Gg          , Gg          , Gg          , Gg          , Gs^Fms      , Gs^Fms      , Gs^Fms      , Gs          , Rd          , Gs          , Gg          , Gg          , Gg          , Gs^Fms      , Gs^Fms      , Gs^Fms      , Gs^Fms      , Gg          , Gg          , Gs^Fms      , Gs^Fms      , Gs^Fms      , Gg          , Gg          
Ww          , Ww          , Ww          , Ds          , Gg          , Gg          , Gg          , Gs^Fms      , Gs^Fms      , Gs^Fms      , Gs^Fms      , Gg          , Gg          , Gg          , Gg          , Gg          , Gg          , Gs^Fms      , Gs          , Gs          , Rd          , Gs          , Gg          , Gs          , Gs          , Gs          , Gs          , Gg          , Gg          , Gg          , Gg          , Gs^Fms      , Gs^Fms      , Gs^Fms      , Gg          , Gg          
Ww          , Ww          , Ww          , Ww          , Gg          , Gg          , Gs^Fms      , Gs^Fp       , Gs^Fp       , Ss          , Gs^Fp       , Gs^Fms      , Gs^Fms      , Gg          , Gg          , Gg          , Gs          , Gs          , Gs          , Rd          , Gs          , Rd          , Gs          , Gs          , Ss          , Ss          , Ss          , Gs          , Gg          , Gg          , Gg          , Gg          , Gg          , Gs^Fms      , Gg          , Gg          
Ww          , Ww          , Ww          , Ww          , Ww          , Gg          , Gs^Fms      , Gs^Fms      , Gs^Fms      , Gs^Fp       , Ss          , Ss          , Gs^Fms      , Gg          , Gs          , Gg          , Gs          , Rd          , Gs          , Gs          , Ss          , Gs          , Rd          , Gs          , Ss^Vhs      , Ss          , Ss          , Ss          , Ss          , Gg          , Gg          , Gg          , Gg          , Gg          , Gg          , Gg          
Ww          , Ww          , Ww          , Ww          , Ds          , Ds          , Gg          , Gs^Fp       , Gs^Fms      , Ss          , Ss          , Gs^Fms      , Re^Gvs      , Re^Gvs      , Gs          , Gs          , Rd          , Rd          , Gg^Vh       , Ss          , Ss          , Gs          , Gs          , Gs          , Gs          , Ss          , Ss          , Ss          , Gg          , Gg          , Gg          , Gg          , Gg          , Gg          , Gg          , Gg          
Wo          , Wo          , Ww          , Ww          , Ds          , Ds          , Gg          , Gg          , Gs          , Gs          , Ss          , Gs          , Gs          , Re^Gvs      , Ww          , Ww^Bsb|     , Ww          , Ww          , Ww          , Ss          , Ww          , Ss          , Gs          , Gs          , Rd          , Gs          , Gs          , Gg          , Gs          , Gg          , Gg          , Gs          , Gs          , Gs          , Gg          , Gg          
Wo          , Wo          , Ww          , Ww          , Ww          , Ds          , Gg          , Gs          , Ss          , Ss          , Gg^Vh       , Ss          , Ww          , Ww          , Ww          , Ww^Bsb|     , Ww          , Ww          , Ww          , Ww          , Ww          , Ww          , Ww          , Gs          , Gs          , Gs          , Gs          , Gs          , Gs          , Gg          , Gg          , Gg          , Gg          , Gs          , Gg          , Gg          
Wo          , Wo          , Wo          , Ww          , Ww          , Gg          , Gs          , Gs          , Ss          , Ss          , Ww          , Ww          , Ww          , Ww          , Ww          , Ww^Bsb|     , Ww          , Wo          , Wo          , Ww          , Ww          , Ww          , Ww^Bsb/     , Rd          , Gs          , Gs          , Gs^Fms      , Gg          , Gg          , Gs          , Gg          , Gg          , Gg          , Gs          , Gg          , Gg          
Wo          , Wo          , Wo          , Ww          , Ww          , Gg          , Gg          , Ww          , Ww          , Ww          , Ww          , Ww          , Wo          , Wo          , Ww          , Ww^Bsb|     , Ce          , Ww          , Ww          , Ww          , Ww^Bsb/     , Ww^Bsb/     , Ww          , Ww          , Ww          , Gs^Fms      , Gs^Fms      , Gs^Fms      , Gs^Fms      , Gg          , Gg          , Gg          , Gg          , Gg          , Gg          , Gg          
Wo          , Wo          , Wo          , Ww          , Ww          , Ww          , Ww          , Ww          , Ww          , Ww          , Wo          , Wo          , Ww          , Ww          , Ch          , Ce          , Ch          , Ww          , Ww^Bsb/     , Ww^Bsb/     , Ww          , Ww          , Ww          , Ww          , Ww          , Ww          , Ww          , Gs^Fms      , Ww          , Gg          , Gg          , Gg          , Gg          , Gg          , Gg          , Gg          
Wo          , Wo          , Wo          , Ww          , Ww          , Ww          , Ww          , Ww          , Ww          , Ww          , Ww          , Ww          , Ds          , Ce          , Gg          , Rr          , Rr          , Ce          , Ch          , Ww          , Ww          , Wo          , Wo          , Ww          , Ww          , Ww          , Ww          , Ww          , Ww          , Ww          , Ww          , Gg          , Ww          , Gg          , Gg          , Gg          
Wo          , Wo          , Wo          , Ww          , Ww          , Ww          , Ww          , Ww          , Wo          , Wo          , Ww          , Ww^Bw\      , Ce          , Ce          , Rp^Vhc      , Rr          , Gs^Fds      , Gg          , Gg          , Ce          , Ds          , Ww          , Ww          , Wo          , Wo          , Ww          , Ww          , Ww          , Ww          , Ww          , Ww          , Ww          , Ww          , Ww          , Ww          , Gg          
Wo          , Wo          , Wo          , Wo          , Wo          , Ww          , Ww          , Ww          , Ww          , Ww          , Ww^Bw\      , Ds          , Ce          , Ce          , Rr          , Rr          , Gg          , Gs^Fds      , Rp^Vhc      , Ce          , Gg^Vh       , Ds          , Gs^Fds      , Ww          , Ww          , Wo          , Wo          , Ww          , Ww          , Ww          , Ww          , Ww          , Ww          , Ww          , Ww          , Ww          
Wo          , Wo          , Wo          , Wo          , Ww          , Ww          , Ww^Bw\      , Ww          , Ce          , Ww          , Ce          , Ce          , Ce          , Rp^Vhc      , Gg          , Rr          , Ce          , Ggf         , Gg          , Ce          , Gg          , Gs^Fds      , Gs^Fds      , Ww          , Ww          , Wo          , Wo          , Wo          , Wo          , Ww          , Ww          , Wo          , Wo          , Wo          , Ww          , Ww          
Wo          , Wo          , Wo          , Wo          , Ww          , Ww          , Ds          , Ds          , Ce          , Ce          , Ww          , Ww          , Ch          , Ce          , Ce          , Rr          , Ch          , Rr          , Ce          , Ce          , Ce          , Gg^Vh       , Ds          , Ww          , Wo          , Wo          , Wo          , Wo          , Wo          , Ww          , Ww          , Ww          , Ww          , Ww          , Ww          , Ww          
Wo          , Wo          , Wo          , Ww          , Ww          , Ww          , Ds          , Ce          , Rr          , Gg^Vh       , Gg          , Ww          , Rr          , Rr          , Rr          , Ch          , 2 Kh        , Ch          , Rr          , Gg          , Ce          , Ds          , Ww          , Ww          , Ww          , Ww          , Ww          , Ww          , Ww          , Ww          , Ds          , Ww          , Ds          , Ww          , Ds          , Ww          
Wo          , Wo          , Wo          , Ww          , Ww          , Ww^Bw\      , Ds          , Ce          , Rr          , Rr          , Rr          , Ww^Bw/      , Ch          , Gg          , Ce          , Ch          , Ch          , Ch          , Ce          , Rp^Vhc      , Ce          , Ds          , Ww          , Wo          , Ww          , Ww          , Ww          , Ww          , Ds          , Ds          , Gg          , Ds          , Ds          , Ds          , Ds          , Ds          
Wo          , Wo          , Wo          , Ww          , Ww          , Ww          , Ds          , Ce          , Ce          , Gg^Vh       , Ggf         , Ww          , Gg          , Ce          , Rp^Vhc      , Rr          , Ce          , Rr          , Gs^Fds      , Ce          , Ch          , Ww          , Wo          , Ww          , Ww          , Ww          , Ww          , Ds          , Gg          , Gg          , Gg          , Gg          , Gg          , Gg          , Gg          , Gg          
Wo          , Wo          , Wo          , Ww          , Ww          , Ww^Bw/      , Ww          , Ds          , Ds          , Ce          , Ww          , Ww          , Gs^Fds      , Gs^Fds      , Gg          , Gg          , Gg          , Rr          , Rr          , Ce          , Rr          , Ww          , Ww          , Ww          , Ww          , Ww          , Ww          , Gg          , Gg          , Gg          , Gg          , Gg          , Gg          , Gg          , Gg          , Gg          
Wo          , Wo          , Wo          , Wo          , Ww          , Ww          , Ww          , Ww^Bw/      , Ww          , Ce          , Ww          , Ww          , Ww          , Gs^Fds      , Gg          , Rp^Vhc      , Rr          , Rr          , Gg^Vh       , Ce          , Ch          , Ww^Bsb\     , Ww^Bsb\     , Ww          , Ww          , Ww          , Gg          , Gg          , Gg          , Gg          , Gg          , Gg          , Gg          , Gg          , Gg          , Gg          
Wo          , Wo          , Wo          , Wo          , Wo          , Ww          , Ww          , Ww          , Ww          , Ww          , Ww          , Wo          , Ww^Bw/      , Ce          , Rr          , Rr          , Gg          , Rr          , Gg          , Ce          , Ce          , Ww          , Ww          , Ww^Bsb\     , Ww^Bsb\     , Ww          , Gg          , Gg          , Gg          , Gg          , Gg          , Gg          , Gs^Fms      , Gg          , Gg          , Gg          
Wo          , Wo          , Wo          , Wo          , Ww          , Ww          , Ww          , Ww          , Ww          , Ww          , Wo          , Ww          , Ww          , Ce          , Ce          , Gg          , Ch          , Rr          , Ch          , Ce          , Ww          , Ww          , Ww          , Ww          , Ww          , Ww^Bsb\     , Gg          , Gg          , Gg          , Gg          , Gs^Fms      , Gs^Fms      , Gs^Fms      , Gs^Fms      , Gs^Fms      , Gg          
Wo          , Wo          , Wo          , Ww          , Ww          , Ww          , Ww          , Ww          , Ww          , Ww          , Ww          , Ww          , Ww          , Ww^Bw/      , Ww          , Ce          , Ww          , Ww^Bsb|     , Ww          , Ww          , Ww          , Ww          , Ww          , Ww          , Ww          , Ww          , Ggf         , Gg          , Gg          , Gg          , Gg          , Gs^Fms      , Gs^Fms      , Gs^Fms      , Gs^Fms      , Gs^Fms      
Wo          , Wo          , Ww          , Ww          , Gg          , Gg          , Gs^Fds      , Ww          , Ww          , Ww          , Ww          , Ww          , Ww          , Ww          , Ww          , Ww          , Ww          , Ww^Bsb|     , Ww          , Ww          , Ww          , Ww          , Ww          , Ww          , Ww          , Ww          , Gg          , Gg          , Gg          , Gg          , Gg          , Gg          , Gg          , Gg          , Gg          , Gg          
Wo          , Wo          , Ww          , Ww          , Gg          , Gs^Fms      , Gs^Fms      , Ww          , Gg          , Ww          , Ww          , Ww          , Ww          , Ww          , Ww          , Ww          , Ww          , Ww^Bsb|     , Ww          , Ww          , Ww          , Ww          , Gg          , Re          , Gg          , Ww          , Ggf         , Gg          , Gg          , Gg          , Gg          , Gg          , Gg          , Gg          , Gg          , Gg          
Wo          , Wo          , Ww          , Ww          , Gg          , Gs^Fds      , Gs^Fds      , Gg^Vh       , Re^Gvs      , Re^Gvs      , Gg          , Ww          , Re^Gvs      , Ww          , Ww          , Ww          , Ww          , Ww^Bsb|     , Gg          , Re^Gvs      , Gg          , Gg          , Re          , Re          , Gg          , Gg          , Gg          , Gg          , Gg          , Gg          , Gg          , Gg          , Gs          , Gg          , Gg          , Gg          
Wo          , Wo          , Wo          , Ww          , Gg          , Gg          , Ggf         , Gg          , Gg          , Gg          , Re^Gvs      , Re^Gvs      , Re^Gvs      , Re^Gvs      , Gg          , Ggf         , Gg          , Re          , Re          , Gg          , Re          , Re          , Gg          , Gg          , Gg^Vh       , Gs^Fms      , Gs^Fms      , Gg          , Gg          , Gg          , Gg          , Gg          , Gs          , Gs          , Gg          , Gg          
Wo          , Wo          , Wo          , Ww          , Ww          , Gg          , Gg          , Gg          , Gs^Fds      , Gs^Fds      , Gs^Fms      , Re^Gvs      , Gg          , Gg          , Gg^Vh       , Gg          , Gs^Fds      , Gs^Fds      , Re          , Re          , Gg          , Gg          , Re^Gvs      , Re^Gvs      , Gs^Fds      , Gs^Fds      , Gs^Fds      , Gg          , Gs^Fms      , Gg          , Gg          , Gg          , Gg          , Gg          , Gg          , Gg          
Wo          , Wo          , Ww          , Ww          , Ww^Bw\      , Ds          , Gg          , Gs^Fms      , Gs^Fds      , Gs^Fds      , Gs^Fms      , Gg          , Gs^Fds      , Gg          , Gg          , Gg          , Gg          , Gs^Fds      , Re          , Gs^Fds      , Gs^Fds      , Gg^Vh       , Re^Gvs      , Re^Gvs      , Gg^Wm       , Gs^Fds      , Gs^Fms      , Gs^Fms      , Gs^Fms      , Gs^Fms      , Gg          , Gg          , Gg          , Gg          , Gg          , Gg          
Wo          , Wo          , Ww          , Ww          , Ds          , Ds          , Gg          , Gg^Vh       , Gs^Fds      , Gs^Fms      , Gs^Fds      , Gs^Fms      , Gs^Fms      , Gg          , Gg          , Gg          , Gg          , Gg          , Re          , Gs^Fds      , Gs^Fds      , Gs^Fds      , Gg          , Gg          , Re^Gvs      , Gg          , Gg          , Gs^Fms      , Gg          , Gg          , Gg          , Gg          , Gg          , Gg          , Gg          , Gg          
Wo          , Wo          , Ww          , Ww^Bw\      , Ds          , Re          , Gg          , Gs^Fds      , Gg          , Gs^Fms      , Gg          , Gg          , Gg          , Gg          , Re          , Re          , Re          , Re          , Re          , Gg          , Gg          , Gg          , Gg          , Re^Gvs      , Re^Gvs      , Gg          , Gg          , Gg          , Gg          , Gg          , Gg          , Gg          , Gg          , Gg          , Gg          , Gg          
Wo          , Wo          , Ww          , Ww          , Ds          , Re          , Re          , Gg          , Re          , Gg          , Re          , Re          , Re          , Re          , Gg          , Gg          , Gg          , Re          , Gg          , Re          , Re          , Re          , Re          , Gg          , Gg          , Gg          , Gg          , Gg          , Gg          , Gg          , Gg          , Gg          , Gg          , Gg          , Gg          , Gg          
Wo          , Wo          , Ww          , Ww^Bw\      , Ds          , Re          , Rr          , Re          , Gg          , Re          , Gg          , Gg          , Gs^Fms      , Gg          , Gg          , Gg          , Gg          , Gg          , Gg          , Gg          , Gg          , Gg^Vh       , Gg          , Re          , Re          , Gg          , Gg          , Gg          , Gg          , Gg          , Gg          , Gg          , Gg          , Gg          , Gg          , Gg          
Wo          , Wo          , Ww          , Ww          , Ds          , Gg^Vh       , Rr          , Gg          , Gs^Fms      , Gg          , Gs^Fds      , Gs^Fds      , Gs^Fds      , Gg          , Gg          , Ggf         , Ggf         , Gg          , Gg          , Gg          , Gs^Fds      , Gg          , Gs^Fms      , Gg          , Gg          , Re          , Re          , Gg          , Gg          , Gg          , Gg          , Gg          , Gg          , Gg          , Gg          , Gg          
Wo          , Wo          , Ww          , Ww          , Gg          , Gg          , Rr          , Gs^Fms      , Gs^Fds      , Gs^Fms      , Gs^Fms      , Gs^Fms      , Gs^Fds      , Gs^Fds      , Gg          , Gg          , Gg          , Gg          , Gg          , Gg          , Gg          , Gs^Fds      , Gs^Fms      , Gs^Fds      , Gs^Fms      , Gg          , Gg          , Re          , Re          , Gg          , Gg          , Gg          , Gg          , Gg          , Gg          , Gg          
Wo          , Wo          , Ww          , Ww          , Gg          , Gg          , Rr          , Gs^Fms      , Gs^Fms      , Gs^Fms      , Gs^Fds      , Gs^Fms      , Gs^Fms      , Gs^Fds      , Gg          , Gg          , Gg          , Gg          , Gg          , Gg          , Gg          , Gs^Fms      , Gs^Fms      , Gs^Fds      , Gs^Fms      , Gg          , Gg          , Re          , Re          , Gg          , Ce          , Gg          , Gg          , Gg          , Gg          , Gg          
Gg          , Gg          , Gg          , Gg          , Gg          , Gg          , Rr          , Gg          , Gg          , Gg          , Gg          , Gg          , Gg          , Gg          , Gg          , Gg          , Gg          , Gg          , Gg          , Gg          , Gg          , Gg          , Gg          , Gs^Fms      , Gs^Fms      , Gg          , Gg          , Gg          , Ce          , Re          , Re          , Gg          , Gg          , Gg          , Gg          , Gg          
Gg          , Gg          , Gg          , Gg          , Gg          , Rr          , Gg          , Gg          , Gg          , Gg          , Gg          , Gg          , Re^Gvs      , Re^Gvs      , Gg          , Gg^Wm       , Gg          , Gg          , Gg          , Gg          , Re^Gvs      , Gg          , Gg          , Gs^Fms      , Gg          , Gs^Fms      , Gg          , Gg          , Gg          , Gg          , Gg          , Re          , Gg          , Gg          , Gg          , Gg          
Gg          , Gg          , Gg          , Gg          , Rr          , Rr          , Gg          , 1 Gg        , Gg          , Gg          , Re^Gvs      , Re^Gvs      , Re^Gvs      , Re^Gvs      , Gg          , Gg          , Gg          , Gg          , Gg          , Re^Gvs      , Re^Gvs      , Re^Gvs      , Re^Gvs      , Gg          , Gg          , Gg          , Gg          , Gg          , Gg          , Gg          , Gg          , Re          , Re          , Gg          , Gg          , Gg          
Gg          , Gg          , Rr          , Rr          , Gg          , Gg          , Gg          , Gg          , Gg          , Re^Gvs      , Re^Gvs      , Re^Gvs      , Gg          , Gg          , Gg          , Gg          , Gg          , Gg          , Gg          , Gg          , Gg          , Re^Gvs      , Gg          , Gg          , Gg          , Gg          , Gg          , Gg          , Gg          , Gg          , Gg          , Gg          , Gg          , Re          , Re          , Gg          
Rr          , Rr          , Gg          , Gg          , Gg          , Gg          , Gg          , Gg          , Gg          , Gg          , Gg          , Gg          , Gg          , Gg          , Gg          , Gg          , Gg          , Gg          , Gg          , Gg          , Gg          , Gg          , Gg          , Gg          , Gg          , Gg          , Gg          , Gg          , Gg          , Gg          , Gg          , Gg          , Gg          , Gg          , Gg          , Re          
Rr          , Rr          , Gg          , Gg          , Gg          , Gg          , Gg          , Gg          , Gg          , Gg          , Gg          , Gg          , Gg          , Gg          , Gg          , Gg          , Gg          , Gg          , Gg          , Gg          , Gg          , Gg          , Gg          , Gg          , Gg          , Gg          , Gg          , Gg          , Gg          , Gg          , Gg          , Gg          , Gg          , Gg          , Gg          , Gg          
