border_size=1
usage=map

Gs          , Gs          , Gs          , Gs          , Gs          , Gs          , Gs          , Ww          , Ww          , Gs          , Gs          , Gs          , Re^Gvs      , Re^Gvs      , Re^Gvs      , Gs          , Gs          , Gs          , Gs          , Gs          , Gs          , Gs          , Gs          , Gs          , Gs          , Gs          , Gs          , Gs          , Gs          , Gs          , Re          , Re          , Hh          , Hh          , Hh          , Hh          , Hh          , Gs^Fp       , Gg          , Gg          , Ww          , Ww          , Ww          , Gg          , Gg          , Gg          , Ww          , Ww          
Gg          , Gg          , Gg          , Gs          , Gs          , Gs          , Gs          , Ww          , Ww          , Gs          , Re^Gvs      , Re^Gvs      , Re^Gvs      , Re^Gvs      , Re^Gvs      , Re^Gvs      , Gs          , Gs          , Gs          , Gs          , Re^Gvs      , Re^Gvs      , Gs          , Gs          , Gg          , Gs          , Gg          , Gs          , Re          , Re          , Hh          , Hh          , Hh^Fp       , Hh          , Hh          , Hh          , Hh^Fp       , Hh          , Hh          , Hh          , Ww          , Ww          , Ww          , Gg          , Gg^Vh       , Gg          , Ww          , Ww          
Rr          , Gg          , Gg          , Gs          , Gg          , Gs          , Gs          , Ww          , Ww          , Re^Gvs      , Re^Gvs      , Re^Gvs      , Re^Gvs      , Re^Gvs      , Gg^Wm       , Gs          , Gs          , Gs          , Re^Gvs      , Re^Gvs      , Gs          , Gg          , Gg          , Gg          , Gg          , Gg          , Gg          , Gg          , Re          , Hh          , Hh^Fp       , Hh          , Hh^Fp       , Hh^Fp       , Hh^Fms      , Hh^Fp       , Hh^Fp       , Hh          , Hh^Fmf      , Ww          , Ww          , Ww          , Ww          , Ww          , Ww          , Ww          , Ww          , Gs^Fp       
Gg          , Rr          , Rr          , Gg          , Gg          , Gg          , Gg          , Ww          , Ww          , Gs          , Gs          , Re^Gvs      , Gs          , Gs          , Gs          , Gs          , Gs          , Gs          , Gs          , Gg          , Gs^Fp       , Gg          , Gg          , Ch          , Ch          , Ch          , Re          , Re          , Gg          , Hh          , Hh          , Hh^Fp       , Hh^Fms      , Hh^Fms      , Hh^Fms      , Hh^Fms      , Hh          , Hh^Fmw      , Hh^Fmf      , Ww          , Ww          , Ww          , Ww          , Ww          , Gg          , Ww          , Gs^Fp       , Gs^Fp       
Gg          , Gg          , Gg          , Rr          , Rr          , Gg          , Gg          , Gg          , Gg          , Ww^Bw/      , Ww          , Gs          , Gs          , Gs          , Gs          , Gs          , Gg          , Gg          , Gg          , Gs^Fp       , Gs^Fp       , Gg          , Gg          , Ch          , 3 Kh        , Ch          , Gg          , Gg          , Gg          , Gg          , Gg          , Hh^Fms      , Hh^Fms      , Hh^Fms      , Hh^Fms      , Hh          , Hh          , Hh^Fmw      , Hh^Fmf      , Hh          , Ww          , Ww          , Ww          , Ww          , Gs^Fp       , Gs^Fp       , Gs^Fp       , Gs^Fp       
Ww          , Gg          , Ww          , Re^Gvs      , Gg          , Rr          , Rr          , Gg          , Gg          , Gg          , Gg          , Ww          , Ww          , Gs          , Gg          , Gg          , Gg          , Gs^Fds      , Gs^Fds      , Gs^Fp       , Gs^Fp       , Gg          , Ch          , Ch          , Ch          , Re          , Gg          , Gg          , Ggf         , Gg          , Gg          , Hh          , Hh          , Hh^Fms      , Hh          , Hh          , Hh^Fp       , Hh          , Hh          , Hh^Vhh      , Ww          , Ww          , Ww          , Ww          , Gs^Fp       , Gs^Fp       , Gs^Fp       , Gs^Fp       
Ww          , Ww          , Ww          , Ww          , Ww          , Ww          , Ww          , Ww          , Rr          , Gg          , Gg          , Gg          , Ww          , Ww          , Ww          , Gg          , Ww          , Gg          , Gg          , Gg          , Gs^Fp       , Gs^Fp       , Gs^Fp       , Gg          , Gg          , Re          , Re          , Gg          , Ggf         , Ggf         , Ggf         , Gg          , Hh          , Hh^Vhh      , Hh          , Hh          , Hh^Fp       , Hh^Fp       , Hh          , Hh          , Ww          , Ww          , Ww          , Hh          , Gs^Fp       , Gs^Fp       , Gs^Fp       , Gs^Fp       
Gg          , Re^Gvs      , Ww          , Ww          , Re^Gvs      , Ww          , Ww          , Ww          , Ww          , Ww^Bw\      , Ww^Bw\      , Ww          , Hh          , Hh          , Hh          , Hh          , Ww          , Ww          , Ww          , Gg^Vh       , Ww          , Gs^Fp       , Gs^Fp       , Gg          , Gg          , Ggf         , Re          , Gg^Vh       , Gg          , Gg          , Gg          , Ggf         , Ggf         , Ggf         , Ggf         , Hh          , Hh^Fp       , Hh^Fp       , Ww          , Ww          , Ww          , Hh          , Ggf         , Ggf         , Gg          , Gs^Fp       , Gg          , Gg          
Gg          , Re^Gvs      , Gs          , Ww          , Ww          , Gg^Wm       , Ww          , Ww          , Ww          , Ww          , Ww          , Ww^Bw\      , Rr          , Rr          , Rr          , Gs^Fp       , Gg          , Gg^Vh       , Gg          , Ww          , Ww          , Gg          , Gg          , Ggf         , Ggf         , Ggf         , Ggf         , Re          , Re          , Gg          , Gg          , Gg          , Gg          , Gg          , Gg          , Hh          , Ww          , Ww          , Ggf         , Ggf         , Ggf         , Ggf         , Ggf         , Ggf         , Gs^Fp       , Gg          , Gg          , Gg          
Gg          , Re^Gvs      , Gs          , Gs          , Re^Gvs      , Ww          , Re^Gvs      , Ww          , Ww          , Ww          , Ww          , Ww          , Ww          , Ww          , Ww          , Rr          , Rr          , Gg          , Gg          , Gs^Fp       , Gg          , Ww          , Gg          , Ggf         , Ggf         , Ggf         , Gg          , Gg          , Re          , Gg          , Gg          , Gg          , Gg          , Gg          , Re          , Ww          , Gs^Fp       , Hh          , Hh          , Ggf         , Ggf         , Ggf         , Ggf         , Ggf         , Gs^Fp       , Gg          , Gg          , Gg          
Gs          , Gs          , Gs          , Gs          , Re^Gvs      , Re^Gvs      , Re^Gvs      , Ww          , Ww          , Ww          , Ww          , Ww          , Ww          , Ww          , Ww          , Ww          , Rr          , Gs^Fp       , Gs^Fp       , Gs^Fp       , Gs^Fp       , Ww          , Gg          , Ggf         , Ggf         , Ggf         , Gg          , Gg          , Re          , Gg          , Gg          , Gg          , Re          , Re          , Gg^Vh       , Ww          , Re          , Gs^Fp       , Re          , Ggf         , Ggf         , Ggf         , Ggf         , Ggf         , Hh          , Gg          , Aa          , Aa          
Gg          , Gg          , Re^Gvs      , Re^Gvs      , Re^Gvs      , Re^Gvs      , Gg          , Ww          , Ww          , Ww          , Ww          , Ww          , Ww          , Ww          , Ww          , Ww          , Gs^Fp       , Rr          , Gs^Fp       , Gs^Fp       , Gs^Fp       , Ww          , Ww          , Gg          , Ggf         , Ggf         , Gg          , Gg          , Re          , Re          , Re          , Re          , Ggf         , Re          , Re          , Ww          , Ww          , Re          , Gs^Fp       , Ggf         , Ggf         , Ggf         , Ggf         , Ggf         , Gg^Vh       , Gg          , Gg          , Aa          
Mm          , Mm          , Gg          , Gg^Wm       , Gg          , Gg          , Gg          , Ww          , Ww          , Ww          , Ww          , Ww          , Ww          , Ww          , Ww          , Gg          , Gs^Fp       , Rr          , Gs^Fp       , Gs^Fp       , Gs^Fp       , Ww          , Ww          , Ww          , Ww          , Ggf         , Gg          , Re          , Gg          , Gg          , Gg          , Ggf         , Ggf         , Ggf         , Ww^Bw|      , Ww          , Ww          , Gg          , Gs^Fp       , Gs^Fp       , Ggf         , Ggf         , Ggf         , Ggf         , Gg          , Gg          , Gg          , Gg          
Mm          , Mm          , Mm          , Gg          , Gg          , Gg          , Gg          , Mm          , Gg          , Ww          , Gg          , Ww          , Ww          , Ggf         , Gg^Vh       , Ww          , Ww          , Rr          , Gs^Fp       , Gs^Fp       , Ww          , Gg^Vh       , Ww          , Ggf         , Ww          , Ggf         , Ww          , Rr          , Rr          , Rr          , Rr          , Rr          , Ww^Bw\      , Ww          , Re          , Ww          , Gg          , Ww          , Gs          , Gg          , Ggf         , Ggf         , Ggf         , Ggf         , Gg^Vh       , Gg          , Rr          , Gg          
Mm          , Mm          , Mm          , Mm          , Gg          , Mm^Vhh      , Mm          , Mm          , Gg          , Gg          , Gg          , Ggf         , Ww          , Ww          , Gg          , Gs^Fp       , Ww          , Ww^Bw|      , Ww          , Ww          , Rr          , Ww          , Rr          , Ggf         , Rr          , Ww          , Ww^Bw/      , Rr          , Gg          , Gg          , Gg          , Gg          , Ww          , Rr          , Rr          , Gs          , Gs          , Ww          , Gs          , Gg          , Gg          , Ggf         , Ggf         , Gs^Fp       , Gg          , Gg          , Rr          , Rr          
Mm          , Mm          , Mm          , Mm          , Mm          , Mm          , Mm          , Mm          , Mm          , Gg          , Gg          , Gg          , Hh          , Ww          , Gs^Fp       , Gs^Fp       , Gg          , Rr          , Rr          , Rr          , Gs^Fp       , Rr          , Re          , Rr          , Ggf         , Rr          , Ww          , Gg^Vh       , Gg          , Gg          , Ww          , Ww          , Ww          , Gg          , Rr          , Gs          , Gs          , Ww          , Gs          , Gg          , Gg^Vh       , Gs^Fp       , Gs^Fp       , Gs^Fp       , Rr          , Rr          , Gg          , Gs          
Mm          , Mm          , Mm          , Mm          , Mm          , Mm          , Mm          , Mm          , Mm          , Mm          , Hh          , Gg          , Hh          , Kh          , Ch          , Gg          , Hh          , Gg          , Hh          , Gs^Fp       , Hh          , Re          , Gg          , Ggf         , Ggf         , Ww          , Ww          , Ww          , Ggf         , Ggf         , Ww          , Ww          , Ww          , Ww          , Ww          , Ww^Bw\      , Ww^Bw\      , Ww          , Ww          , Ww          , Ww          , Ww          , Ww^Bw/      , Rr          , Gg          , Gg          , Gs          , Gs          
Mm          , Mm          , Mm          , Mm          , Mm          , Mm          , Mm          , Mm          , Mm          , Mm          , Mm          , Hh          , Hh          , Hh          , Hh          , Ch          , Kh          , Hh          , Hh          , Hh          , Hh          , Hh          , Gg          , Gg          , Gg          , Gg          , Gg          , Gg          , Gg          , Ww          , Ww          , Ww          , Ww          , Ww          , Ww          , Ww          , Ww          , Rr          , Ww^Bw\      , Ww          , 2 Rr        , Rr          , Ww          , Gg          , Gg          , Gg          , Gg          , Gg          
Mm          , Mm          , Mm          , Mm          , Mm          , Mm          , Mm          , Mm          , Mm          , Mm          , Mm          , Mm          , Hh          , Hh          , Hh          , Hh          , Hh          , Ch          , Ch          , Hh          , Hh          , Gg          , Gg          , Gg          , Ggf         , Gg          , Ggf         , Gg          , Gg          , Gg          , Ww          , Ggf         , Gs          , Gs          , Re          , Gg          , Gg          , Ww          , Ww          , Rr          , Gg          , Gg          , Gg          , Ww          , Ww          , Gg          , Gg          , Gg          
Mm          , Mm          , Mm          , Mm          , Mm          , Mm          , Mm          , Mm          , Mm          , Mm          , Mm          , Hh          , Hh          , Hh          , Hh          , Hh          , Hh          , Hh          , Hh          , Kh          , Hh          , Gg          , Gg          , Ggf         , Ggf         , Ggf         , Gg          , Gg          , Ww          , Ww          , Gg          , Gg^Vh       , Gs          , Gs          , Re          , Gg          , Gg          , Gg          , Ww          , Gs          , Gg          , Gg          , Ww          , Ww          , Ww          , Gg          , Gg          , Gg          
Mm          , Mm          , Mm          , Mm          , Mm          , Mm          , Mm          , Mm          , Mm          , Mm          , Mm          , Mm          , Hh          , Hh          , Hh          , Hh          , Hh          , Hh          , Hh          , Hh          , Gg          , Gg          , Gg          , Ggf         , Gg          , Gg          , Gg          , Gg          , Ww          , Gg          , Gg          , Gg          , Gg          , Gg          , Hh          , Re          , Re          , Gg          , Ww          , Gg          , Ww          , Ww          , Gg          , Ww          , Ww          , Gg          , Gg          , Gg          
Mm          , Mm          , Mm          , Mm          , Mm          , Mm          , Mm          , Mm          , Mm          , Mm          , Xos         , Xos         , Hh^Xo       , 1 Hh        , Hh          , Hh          , Hh          , Ggf         , Hh          , Hh          , Gg          , Gg          , Gg          , Gg          , Gg          , Gg          , Gg          , Gg^Vh       , Ww          , Hh          , Hh          , Hh          , Hh          , Hh          , Hh          , Gs^Fp       , Re          , Gg          , Ww          , Gg^Vh       , Ww          , Gs^Fp       , Gs^Fp       , Gs^Fp       , Ww          , Ww          , Ww          , Ww          
Mm          , Mm          , Mm^Vhh      , Mm          , Mm          , Mm          , Mm          , Mm          , Mm          , Mm          , Xos         , Ur          , Xos         , Xos         , Mm          , Hh          , Hh          , Hh          , Hh          , Hh          , Hh          , Gg          , Gg          , Gg          , Gg          , Gg          , Ww          , Ww          , Hh          , Hh          , Hh          , Hh          , Hh          , Hh          , Hh          , Hh          , Hh          , Re          , Ww          , Ww          , Gs^Fp       , Gg          , Gg          , Gs^Fp       , Gs^Fp       , Ww          , Gg          , Gg          
Mm          , Mm          , Mm          , Mm          , Mm          , Mm          , Mm          , Mm          , Mm          , Mm          , Mm          , Xos         , Mm          , Mm          , Mm          , Mm          , Mm          , Mm          , Mm          , Hh          , Hh          , Hh          , Gg^Vh       , Gg          , Mm          , Mm          , Ww          , Hh          , Mm          , Mm          , Mm          , Mm          , Mm          , Mm          , Hh          , Hh          , Hh          , Re          , Gg          , Gs^Fp       , Gg          , Gg          , Gg          , Gs^Fp       , Ww          , Ww          , Ww          , Gg          
Mm          , Mm          , Mm          , Mm          , Mm          , Mm          , Mm          , Mm          , Mm          , Mm          , Mm          , Mm          , Mm          , Mm          , Mm          , Mm          , Ha          , Ha          , Mm          , Mm          , Mm          , Mm          , Mm          , Mm          , Ww          , Ww          , Ww          , Mm          , Mm          , Mm          , Mm          , Mm          , Mm          , Mm          , Mm^Vhh      , Hh          , Re          , Re          , Gs^Fp       , Gs^Fp       , Gg          , Gg          , Gg          , Ww          , Gs^Fp       , Ww          , Ww          , Gg          
Mm          , Mm          , Mm          , Mm          , Mm          , Mm          , Mm          , Mm          , Mm          , Mm          , Mm          , Mm          , Mm          , Mm          , Hh          , Mm          , Ha          , Ha          , Ha          , Mm          , Mm          , Mm          , Mm          , Mm          , Ww          , Hh          , Mm          , Mm          , Mm          , Mm          , Mm          , Mm          , Mm          , Mm          , Mm          , Re          , Hh          , Hh          , Hh          , Hh          , Hh          , Hh          , Gs^Fp       , Ww          , Gs^Fp       , Gg          , Gg          , Ww          
Mm          , Mm          , Mm          , Mm          , Mm          , Mm          , Mm          , Mm          , Mm          , Mm          , Mm          , Mm          , Mm          , Re          , Re          , Mm          , Mm          , Ha          , Ww          , Ha          , Mm          , Mm          , Mm          , Mm          , Ww          , Mm          , Mm          , Mm          , Mm          , Mm          , Mm          , Mm          , Mm          , Mm          , Mm          , Re          , Hh          , Hh          , Hh          , Hh          , Hh          , Hh          , Hh          , Ww          , Hh          , Gs^Fp       , Gg          , Gg          
