border_size=1
usage=map

Md          , Md          , Md          , Md          , Hh          , Hh          , Hh          , Hh          , Rb          , Rb          , Rb          , Gs          , Gs          , Gs          , Hh^Fds      , Gs          , Gs          , Gs          , Gs          , Ww          , Ww^Ewl      , Gs          , Hh^Fds      , Hh^Fds      , Hh^Fds      , Gd          , Gd          , Gs          , Gs          , Gs          , Gs          , Gd          , Gd          , Gs          
Md          , Md          , Hh          , Hh          , Gs          , Hh          , Rb          , Rb^Bw\r     , Gs^Bw\r     , Hh          , Hh          , Rb          , Rb          , Hh^Fds      , Rb          , Rb          , Rb          , Gs          , Gs          , Ww          , Ww          , Gs          , Hh^Fds      , Hh^Fds      , Gd          , Gd          , Gs^Vl       , Gs          , Gs          , Gs          , Gs          , Gd          , Gd          , Gs          
Hh          , Hh^Fp       , Hh^Fp       , Hh          , Rb          , Rb          , Hh          , Hh          , Hh          , Hh          , Md          , Hh          , Hh          , Rb          , Gs          , Rb          , Gs          , Rb          , Rb          , Ww^Bw\r     , Ww^Bw\r     , Gd          , Gd          , Gd          , Gd          , Gd          , Gs          , Gs          , Ce          , Ce          , 1 Ke        , Gd          , Gd          , Gs          
Hh^Fp       , Hh^Fp       , Rb          , Rb^Bw\r     , Cud         , Cud         , Cud         , Hh          , Md          , Md          , Mm          , Md          , Hh          , Hh          , Hh          , Gs          , Gs          , Gs          , Ww          , Ww          , Gs          , Gs          , Gs          , Gd          , Gs^Vl       , Gs          , Gs          , Gs          , Ce          , Ce          , Ce          , Gd          , Gd          , Gs          
Hh          , Rb          , Hh          , Hh          , Cud         , 2 Kud       , Cud         , Md          , Mm          , Mm          , Mm          , Mm          , Md          , Hhd^Vhhr    , Hh          , Hh          , Ww          , Ww          , Hh          , Gs          , Gs          , Gs          , Gs          , Gs          , Gs          , Gs          , Gd          , Ce          , Gs          , Ce          , Gs          , Gd          , Gd          , Gs          
Rb          , Rb          , Hh          , Hh          , Hh          , Cud         , Hh          , Mm          , Mm          , Mm          , Md          , Md          , Ww          , Ww          , Ww          , Ww          , Ww          , Hh          , Hh          , Hh          , Hh^Fds      , Hh          , Hh          , Gs          , Rb          , Rb          , Gd          , Gd          , Gd          , Gd          , Gd          , Gd          , Gd          , Gs          
Gs          , Hh^Fp       , Hh^Fp       , Hh          , Hh          , Hh          , Mm          , Mm          , Md          , Md          , Ww          , Ww          , Mm          , Md          , Md          , Hh          , Md          , Ww          , Ww          , Hh          , Hh          , Hh          , Hh          , Hh          , Gs          , Gs          , Hh          , Gs          , Gs          , Gs          , Gs^Vl       , Gd          , Gs          , Gs          
Gs          , Hh^Fp       , Hh^Fp       , Hh          , Hh          , Hh          , Hh          , Md          , Ww          , Ww          , Hh          , Mm          , Mm          , Mm          , Mm^Xm       , Md          , Md          , Md          , Md          , Ww          , Ww          , Hhd^Vhhr    , Hh          , Hh          , Hh          , Hh          , Hh^Fds      , Hh          , Hh^Fds      , Hh          , Hh          , Gd          , Gs          , Gs          
Gs          , Gs          , Hh^Fp       , Hh^Fp       , Hh          , Hh          , Hh          , Hh          , Ww          , Hh          , Md          , Md          , Mm          , Mm^Xm       , Ms^Xm       , Ms^Xm       , Mm^Xm       , Md          , Md          , Md          , Ww          , Hh          , Hh          , Hh          , Hh          , Hh^Fds      , Hh^Fds      , Hh^Fds      , Hh^Fds      , Hh          , Hh          , Gs          , Gs          , Gs          
Gs          , Hh^Fp       , Hh^Fp       , Hh          , Hh          , Hhd^Vhhr    , Hh          , Hh          , Ww^Bw/      , Hh          , Hh          , Md          , Md          , Mm          , Md          , Mm^Xm       , Md          , Md          , Md          , Md          , Ww          , Hh          , Hh          , Hh          , Hh          , Hh^Fds      , Hh          , Hh          , Hh          , Hh          , Hh          , Hh          , Hh          , Gs          
Gs          , Gs          , Hh^Fp       , Hh          , Hh          , Hh          , Hh          , Hh          , Ww          , Hh          , Hh          , Hh          , Hh          , Md          , Md          , Md          , Md          , Md          , Ww          , Ww          , Hh          , Hh          , Hh          , Hh          , Md          , Hh          , Md          , Hh          , Hhd^Vhhr    , Hh          , Hh          , Hh          , Hh          , Hh          
Gs          , Gs          , Gs          , Gs          , Gs          , Hh          , Hh          , Hh          , Ww          , Hh          , Hh          , Hh          , Hhd^Vhhr    , Hh          , Hh          , Md          , Ww          , Ww          , Hh          , Hh          , Md          , Md          , Md          , Md          , Md          , Md          , Md          , Md          , Hh          , Md          , Md          , Hh          , Hh          , Hh          
Gs^Fms      , Gd          , Gs^Fms      , Gs          , Gs          , Gs          , Gs          , Hh          , Ww          , Hh          , Hh          , Hh          , Hh          , Hh          , Ww^Bw\      , Ww          , Hh          , Hh          , Hh          , Md          , Md          , Md          , Md          , Md          , Md          , Md          , Md          , Md          , Md          , Md          , Md          , Hh          , Hh          , Hh          
Gd          , Gs^Fms      , Gd          , Gs^Fms      , Gs          , Gs          , Gs          , Ww          , Hh          , Hh          , Hh          , Hh          , Ww          , Ww          , Hh          , Hh          , Hh          , Hh          , Hh          , Hhd^Vhhr    , Hh          , Md          , Md          , Md          , Md          , Md          , Md          , Md          , Md          , Hh          , Hh          , Hh          , Hh^Fds      , Hh          
Gd          , Gd          , Gd          , Gd          , Gd          , Gs          , Gs          , Ww          , Hh          , Hh          , Ww          , Ww          , Hh          , Hh          , Hh          , Hh          , Hh          , Hh          , Hh^Gvs      , Hh^Gvs      , Hh^Gvs      , Hh          , Hh          , Md          , Hh          , Md          , Md          , Md          , Md          , Hh          , Hh          , Hh^Fds      , Hh^Fds      , Hh          
Gs^Fms      , Gd          , Gd          , Gd          , Gd          , Gs          , Gs          , Ww          , Gs          , Hh          , Ww          , Hh          , Gs          , Hh          , Gs          , Hh          , Hh          , Hh^Gvs      , Hh^Gvs      , Hh^Gvs      , Hh          , Hhd^Vhhr    , Hh          , Hh          , Ms          , Md          , Hh          , Md          , Hh          , Hh          , Hh^Vhh      , Hh^Fds      , Hh          , Hh          
Gs^Fms      , Gs^Fms      , Gs^Fms      , Gd          , Gd          , Gs          , Gs          , Ww          , Gs          , Gs          , Ww          , Gs          , Gs          , Gs          , Gs          , Gs          , Hh          , Hh          , Hh          , Hh          , Hh          , Hh          , Mm^Xm       , Mm^Xm       , Mm^Xm       , Ms          , Ms          , Hh          , Hh          , Hh          , Hh^Fds      , Hh          , Hh^Fds      , Hh          
Gs^Fms      , Gs^Fms      , Gs          , Gd          , Gs          , Gs          , Gs          , Ww          , Ww^Ewl      , Ww          , Gs          , Gs          , Gs          , Gs          , Gs          , Gs          , Gs          , Hh          , Hh          , Hh          , Hh          , Hh          , Mm^Xm       , Ms^Xm       , Ms^Xm       , Mm^Xm       , Mm^Xm       , Md          , Hh          , Hh          , Hh          , Hh^Fds      , Hh          , Hh          
Gs          , Gs          , Ww          , Gs          , Ww          , Gs          , Ww          , Ww          , Gs          , Gs          , Gs          , Gs          , Gs^Gvs      , Gs^Gvs      , Gd^Gvs      , Gs          , Gd          , Gs          , Gs          , Hh          , Hh          , Hh          , Mm^Xm       , Ms^Xm       , Ms^Xm       , Mm^Xm       , Mm^Xm       , Md          , Hh          , Hh          , Co          , Hh          , Hh          , Hh          
Ww          , Ww          , Gs          , Ww          , Gs          , Ww          , Gs          , Gs          , Gs          , Gs          , Gs^Gvs      , Gs^Gvs      , Gd^Gvs      , Gd^Gvs      , Gd          , Hhd^Vhhr    , Gs          , Gs          , Gs^Esd      , Gs          , Hh          , Hh          , Md          , Mm^Xm       , Md          , Mm^Xm       , Md          , Md          , Hh          , Co          , Co          , Co          , Hh          , Hh          
Gs          , Gs          , Gs^Fms      , Gs          , Gs^Fms      , Gs          , Gs          , Gs          , Gs^Fms      , Gs          , Gs^Fms      , Gs^Gvs      , Gs          , Gd^Wm       , Gs          , Gd          , Gs          , Gs          , Gs          , Gs          , Hh          , Hh          , Hh          , Hh          , Hh          , Md          , Hh          , Hh          , Hh          , Co          , Co          , 3 Ko        , Hh          , Hh          
Gs^Fms      , Gs^Fms      , Gs^Fms      , Gs^Fms      , Gs          , Gs^Fms      , Gs          , Gs          , Gs          , Gs^Fms      , Gs          , Gs^Fms      , Gs^Fms      , Gs^Fms      , Gs^Fms      , Gs^Fms      , Gs          , Gs^Fms      , Gs^Fms      , Gs^Fms      , Gs^Fms      , Hh          , Hh^Fp       , Hh^Fp       , Hh^Fp       , Hh^Fp       , Hh          , Hh          , Hh          , Hh          , Hh          , Hh          , Hh          , Hh          
